input,out,len,bins,pred,total-tokens,prompt-tokens,completion-tokens
Stefan Joachim Monika Uwe Bernd Dirk Philipp Angelika Hans Anja Jürgen Jürgen Anna Markus Birgit Jan Sabine Ralph,n m a e d k p a s a n n a s t n e h,18,15~22,Output: n m a e d k p a n a n k t,234,219,15
Sabine Kerstin Heike Birgit Petra Brigitte Martina Anja Rainer Ute Bärbel Wolfgang Heike Hans Hans Wolfgang Susanne Jutta,e n e t a e a a r e l g e s s g e a,18,15~22,Output: e n e e t e e r e e e a e,234,219,15
Stefanie Monika Wolfgang Jörg Martina Stefan Thomas Uwe Martina Bernd Manfred Bernd Sven Katharina Kerstin Philipp Ralph Angelika Dirk,e a g g a n s e a d d d n a n p h a k,19,15~22,Output: e a g g n s h s n a d a n d r a a,239,220,19
Thomas Heike Bettina Uwe Jens Stefan Jens Jörg Klaus Heike Stefan Markus Heike Angelika Sabine Martina Kerstin Ivonne Markus Bernd,s e a e s n s g s e n s e a e a n e s d,20,15~22,Output: s e a e e s g e k e n a e n a,236,219,17
Bernd Manfred Hans Brigitte Katharina Jan Sven Anja Birgit Karin Philipp Matthias Katharina Jutta Martina Anja Stefanie Ralph Jörg,d d s e a n n a t n p s a a a a e h g,19,15~22,Output: d d s e e n a t a a a h a a e g,241,223,18
Markus Bärbel Ivonne Philipp Sabine Stefanie Petra Jörg Bettina Ute Ulrike Heike Markus Joachim Dirk Ralph Susanne Sabine Uwe Markus Thorsten,s l e p e e a g a e e e s m k h e e e s n,21,15~22,Output: s l e n e e i e e k e e e h e n,242,224,18
Stefan Monika Anja Bärbel Karin Markus Jörg Birgit Sabine Brigitte Martina Thomas Jörg Philipp Birgit Uwe Jan Bettina Anja Heike,n a a l n s g t e e a s g p t e n a a e,20,15~22,Output: n a a l n g t e g e t e n a e e k e,245,225,20
Jan Bettina Katharina Angelika Katharina Petra Manfred Uwe Jörg Jürgen Sven Stefan Ralph Stefanie Sabine Klaus Susanne Uwe Stefanie Bernd Klaus,n a a a a a d e g n n n h e e s e e e d s,21,15~22,Output: n a a a a a d f g n e n e e e,244,227,17
Ulrike Dirk Philipp Jürgen Sven Rainer Klaus Anna Brigitte Stefanie Hans Anja Jörg Monika Bettina Matthias Monika Dirk Philipp Ralph,e k p n n r s a e e s a g a a s a k p h,20,15~22,Output: e k p n r s s e t e n a e g a k a,240,221,19
Manfred Wolfgang Angelika Martina Stefan Joachim Brigitte Manfred Ivonne Angelika Katharina Stefanie Hans Anja Jan Petra,d g a a n m e d e a a e s a n a,16,15~22,Output: d g a a n m h e e a a a e,231,216,15
Wolfgang Anja Monika Katharina Birgit Klaus Rainer Anna Susanne Katharina Jens Anja Heike Birgit Ulrike,g a a a t s r a e a s a e t e,15,15~22,Output: g a a a t s s e n a e e k e,230,214,16
Jan Brigitte Manfred Matthias Heike Jutta Jürgen Bärbel Karin Susanne Dirk Bernd Anja Jörg Katharina Jutta Joachim Birgit Philipp Bernd Ralph,n e d s e a n l n e k d a g a a m t p d h,21,15~22,Output: n e d s e k e n a n g e n a n d t h,250,230,20
Anna Philipp Petra Jörg Jens Brigitte Angelika Jörg Karin Bärbel Rainer Joachim Bettina Hans Jörg Matthias Ralph Birgit,a p a g s e a g n l r m a s g s h t,18,15~22,Output: a p a g n e k a n l e n a h t i n a h t,243,221,22
Wolfgang Heike Hans Jens Martina Anna Matthias Susanne Anja Jens Jutta Petra Monika Stefan Monika Angelika Bernd Heike Jörg Uwe Bettina,g e s s a a s e a s a a a n a a d e g e a,21,15~22,Output: g e s s a a h n e s s a n k a a n k a,242,221,21
Ute Stefan Ute Monika Susanne Thorsten Birgit Bettina Jens Brigitte Heike Jörg Thorsten Hans Ralph Susanne Philipp Katharina Brigitte Ralph,e n e a e n t a s e e g n s h e p a e h,20,15~22,Output: e n e e e n t t e k e e e h e e,242,224,18
Ute Karin Wolfgang Dirk Stefan Anna Jürgen Hans Bettina Monika Jan Katharina Markus Ivonne Ute Bettina Hans Sven Thorsten,e n g k n a n s a a n a s e e a s n n,19,15~22,Output: e n g k r a n j n a a n k e e n a,238,219,19
Stefan Rainer Jan Bärbel Anna Dirk Sven Jürgen Sven Klaus Heike Bernd Bernd Stefanie Klaus Stefan Markus Monika Karin Thomas Anna,n r n l a k n n n s e d d e s n s a n s a,21,15~22,Output: n r n l e k s n g e k s n a n k a h e k s n,245,221,24
Ralph Karin Uwe Hans Manfred Thomas Karin Sven Rainer Jürgen Stefan Thorsten Anja Manfred Ulrike Heike,h n e s d s n n r n n n a d e e,16,15~22,Output: h n e e s s n r n n e e k e,232,216,16
Ivonne Sabine Philipp Dirk Katharina Uwe Katharina Jörg Klaus Ivonne Kerstin Jörg Stefan Heike Thorsten Katharina,e e p k a e a g s e n g n e n a,16,15~22,Output: e e p k a e g n e n e k,233,219,14
Jan Bärbel Karin Hans Hans Sabine Sven Anja Jürgen Heike Ulrike Heike Bettina Heike Jörg Bettina Ivonne Jan Kerstin Dirk Karin,n l n s s e n a n e e e a e g a e n n k n,21,15~22,Output: n l n s s n a n e e e k a n n,244,227,17
Jutta Klaus Dirk Heike Bärbel Hans Jan Wolfgang Stefanie Hans Jutta Jan Joachim Birgit Sven Birgit Hans Karin,a s k e l s n g e s a n m t n t s n,18,15~22,Output: a s k e e l s n e n a n t g t,233,216,17
Monika Kerstin Bärbel Angelika Philipp Ute Joachim Sabine Rainer Ivonne Anja Dirk Stefan Uwe Bernd Hans Susanne,a n l a p e m e r e a k n e d s e,17,15~22,Output: a n l a a h m e n e i e r n a,235,218,17
Uwe Jörg Monika Susanne Susanne Jan Birgit Katharina Joachim Birgit Angelika Rainer Philipp Brigitte Stefan Ivonne Karin Markus Jens Jörg,e g a e e n t a m t a r p e n e n s s g,20,15~22,Output: e g a e e n t m h e t e r n e e t e,246,226,20
Philipp Bettina Susanne Bernd Brigitte Bärbel Kerstin Monika Jörg Petra Thomas Sabine Dirk Anna Stefan,p a e d e l n a g a s e k a n,15,15~22,Output: p a e d t e n a g e t a n,228,213,15
Katharina Katharina Uwe Philipp Anja Petra Joachim Jürgen Jörg Heike Stefanie Heike Anna Stefanie Rainer,a a e p a a m n g e e e a e r,15,15~22,Output: a a e p a a m n e e e a e r,235,219,16
Bettina Susanne Kerstin Sven Manfred Angelika Ivonne Angelika Stefanie Thomas Klaus Sabine Bettina Anja Anna Jutta Dirk Ute Susanne,a e n n d a e a e s s e a a a a k e e,19,15~22,Output: a e n n d a a e e a e e a a e,237,220,17
Brigitte Ute Sabine Susanne Bettina Ulrike Martina Ute Anja Markus Karin Stefanie Jens Thorsten Kerstin Karin Ralph Bärbel Philipp Jan,e e e e a e a e a s n e s n n n h l p n,20,15~22,Output: e e e e a a a e n e e n h l e,240,223,17
Jürgen Kerstin Anja Klaus Katharina Jan Manfred Joachim Petra Philipp Angelika Ute Stefanie Joachim Katharina Brigitte,n n a s a n d m a p a e e m a e,16,15~22,Output: n n a s s n m m h a e e e,236,221,15
Ulrike Petra Ivonne Jens Joachim Katharina Hans Thorsten Kerstin Heike Ivonne Joachim Rainer Thomas Bärbel Petra Ulrike Matthias Karin Sabine Jürgen,e a e s m a s n n e e m r s l a e s n e n,21,15~22,Output: e a e s m n a e k e e n r s e,245,228,17
Manfred Katharina Thorsten Bettina Wolfgang Heike Anna Jan Jens Ivonne Thomas Bärbel Monika Jan Hans Brigitte Anna Ulrike Martina Jörg,d a n a g e a n s e s l a n s e a e a g,20,15~22,Output: d a n n a e k e n n a s s e n a e e e,243,222,21
Anna Ralph Martina Anna Markus Angelika Kerstin Heike Katharina Klaus Brigitte Brigitte Sabine Wolfgang Petra Jürgen Dirk,a h a a s a n e a s e e e g a n k,17,15~22,Output: a h a a s a a e e e t e,231,217,14
Jan Bettina Martina Ivonne Ivonne Bärbel Monika Jens Heike Hans Bernd Ute Jan Martina Anja Birgit Kerstin Rainer Brigitte,n a a e e l a s e s d e n a a t n r e,19,15~22,Output: n a a e e l e n k e e e t e n a,240,222,18
Sven Jürgen Markus Ute Stefan Monika Ulrike Uwe Stefan Joachim Manfred Ivonne Birgit Klaus Jens Ralph,n n s e n a e e n m d e t s s h,16,15~22,Output: n n s e n a e m d e t,228,215,13
Joachim Sabine Bernd Katharina Stefanie Stefan Jens Bärbel Anna Angelika Jan Sabine Martina Ivonne Sabine Petra Stefan Kerstin,m e d a e n s l a a n e a e e a n n,18,15~22,Output: m e d n a e n s a a a e e n a,236,219,17
Joachim Uwe Jens Heike Ute Sabine Ralph Ulrike Stefan Bernd Jens Uwe Sven Thomas Philipp Sabine Jens Thorsten Ralph Petra,m e s e e e h e n d s e n s p e s n h a,20,15~22,Output: m e s e e e n e n d n a n e n,235,218,17
Matthias Ulrike Ralph Katharina Karin Anna Manfred Katharina Katharina Birgit Rainer Thomas Sven Susanne Jutta,s e h a n a d a a t r s n e a,15,15~22,Output: s e h a n a d a a t n e r,230,215,15
Ralph Monika Sabine Bärbel Thomas Bärbel Manfred Rainer Jens Stefan Anja Heike Kerstin Jörg Jan Joachim Jan Bettina,h a e l s l d r s n a e n g n m n a,18,15~22,Output: h a e l b s h d r n a e k j m j m,239,220,19
Jan Sabine Katharina Ulrike Angelika Stefan Bettina Katharina Kerstin Manfred Bettina Ivonne Brigitte Jens Heike Bärbel Bärbel Stefan Rainer Thorsten Brigitte,n e a e a n a a n d a e e s e l l n r n e,21,15~22,Output: n e a e a k a n a n e e e e e,247,230,17
Katharina Thomas Klaus Dirk Bernd Stefanie Markus Angelika Klaus Uwe Bettina Stefanie Ralph Monika Markus Jörg Philipp Klaus Markus Anna,a s s k d e s a s e a e h a s g p s s a,20,15~22,Output: a s s k d e e a k s a e e a k a,235,217,18
Joachim Angelika Anja Ulrike Jörg Markus Ulrike Petra Jürgen Dirk Ulrike Bettina Jan Ulrike Markus,m a a e g s e a n k e a n e s,15,15~22,Output: m a a e g k e e n a n k a,230,215,15
Sabine Markus Jan Jens Wolfgang Klaus Rainer Philipp Jutta Jutta Karin Jürgen Klaus Jens Jutta Hans Karin Wolfgang Birgit,e s n s g s r p a a n n s s a s n g t,19,15~22,Output: e s n s g l r p a n n a n k n g t,235,216,19
Angelika Rainer Ute Birgit Hans Hans Bernd Jörg Anna Susanne Angelika Petra Martina Stefanie Birgit,a r e t s s d g a e a a a e t,15,15~22,Output: a r e t s h s d a a e e,227,213,14
Joachim Jutta Matthias Stefan Stefan Rainer Klaus Bernd Thomas Bärbel Monika Manfred Karin Stefan Karin Jens Sabine,m a s n n r s d s l a d n n n s e,17,15~22,Output: m a s n r s s n k l b l a n k s e,234,215,19
Sabine Ulrike Ute Brigitte Ivonne Bettina Jörg Stefan Manfred Jürgen Anna Jörg Stefan Karin Angelika Ivonne Stefanie Sven Jan Thorsten,e e e e e a g n d n a g n n a e e n n n,20,15~22,Output: e e e e e n n d a n n a a e e e n,246,227,19
Sabine Martina Birgit Ulrike Angelika Jutta Ralph Ulrike Anna Thorsten Susanne Jens Ivonne Heike Brigitte Angelika Ulrike Jürgen Birgit Rainer,e a t e a a h e a n e s e e e a e n t r,20,15~22,Output: e a t e k a h e a e n e e e e n,244,226,18
Brigitte Stefan Katharina Susanne Anna Joachim Wolfgang Jan Birgit Anja Susanne Joachim Bettina Heike Ralph,e n a e a m g n t a e m a e h,15,15~22,Output: e n a e n m h a n a m n a e h e,233,215,18
Karin Bärbel Bärbel Philipp Stefanie Manfred Wolfgang Joachim Rainer Manfred Katharina Stefanie Ulrike Joachim Ulrike,n l l p e d g m r d a e e m e,15,15~22,Output: n l l p e d g m h n a e e e,235,219,16
Jörg Manfred Anna Philipp Angelika Heike Wolfgang Jutta Karin Monika Martina Susanne Brigitte Ute Susanne Jörg Markus,g d a p a e g a n a a e e e e g s,17,15~22,Output: g d a h k a e g a a n a e e,235,219,16
Monika Jan Matthias Sabine Jutta Jan Markus Uwe Bettina Monika Ralph Joachim Bettina Anna Anja Uwe Bettina Birgit,a n s e a n s e a a h m a a a e a t,18,15~22,Output: a n s e a n k a n a a a t i n a,235,217,18
Heike Jürgen Rainer Birgit Ralph Sven Rainer Martina Jürgen Ulrike Jürgen Katharina Monika Jens Bernd,e n r t h n r a n e n a a s d,15,15~22,Output: e n r t h g n r a e n e n a k a,239,221,18
Thomas Matthias Jens Birgit Ivonne Jan Bärbel Birgit Rainer Jan Jan Jan Monika Rainer Katharina Jan Hans Katharina Karin Kerstin,s s s t e n l t r n n n a r a n s a n n,20,15~22,Output: s s s t e n n r n a n a a n a a,238,220,18
Kerstin Monika Kerstin Sabine Philipp Jürgen Klaus Heike Dirk Jan Wolfgang Jürgen Manfred Markus Monika Wolfgang Anna Petra Uwe,n a n e p n s e k n g n d s a g a a e,19,15~22,Output: n a n e n g n e k e d k a n a,236,219,17
Ulrike Jutta Markus Jürgen Uwe Sven Martina Uwe Jutta Bettina Jutta Ralph Sabine Wolfgang Angelika Dirk Jutta Bettina Ulrike Ute Jörg,e a s n e n a e a a a h e g a k a a e e g,21,15~22,Output: e a s n e e s e n a e n a e g e,245,227,18
Kerstin Uwe Monika Jürgen Anja Brigitte Sven Thorsten Bärbel Anja Matthias Wolfgang Stefan Ivonne Jörg Rainer Stefanie Klaus Ralph Sven,n e a n a e n n l a s g n e g r e s h n,20,15~22,Output: n e a n g e e t n e n t e n r,243,226,17
Brigitte Jörg Ulrike Sabine Markus Thomas Petra Sabine Ralph Klaus Brigitte Susanne Jan Bettina Katharina Katharina,e g e e s s a e h s e e n a a a,16,15~22,Output: e g e e s s h a e e e a a a,233,217,16
Stefanie Ralph Petra Monika Jürgen Thomas Thorsten Philipp Markus Bernd Jens Brigitte Sabine Anja Petra Ivonne Ulrike Katharina,e h a a n s n p s d s e e a a e e a,18,15~22,Output: e h a a n s n t h n e e a e a e,237,219,18
Ralph Petra Karin Wolfgang Brigitte Jürgen Hans Manfred Bärbel Jutta Monika Sabine Jürgen Thomas Ute Matthias Stefanie Thomas Martina Hans Ute,h a n g e n s d l a a e n s e s e s a s e,21,15~22,Output: h a n e e n n d l e n a s e n a h,245,226,19
Joachim Bernd Karin Joachim Angelika Martina Dirk Jutta Ute Joachim Ulrike Uwe Jutta Birgit Ulrike Jörg Martina Dirk Bettina,m d n m a a k a e m e e a t e g a k a,19,15~22,Output: m d n a a a k a e e e t a a,242,226,16
Jutta Jutta Jens Joachim Jutta Jan Rainer Anna Joachim Markus Uwe Martina Stefanie Monika Heike Jens Sabine Thorsten,a a s m a n r a m s e a e a e s e n,18,15~22,Output: a a s m h n a m e e e e,233,219,14
Heike Joachim Katharina Birgit Susanne Matthias Hans Jens Matthias Kerstin Ivonne Katharina Joachim Wolfgang Jörg Martina Monika,e m a t e s s s s n e a m g g a a,17,15~22,Output: e m a t e n s h s n a a n a,236,220,16
Susanne Stefan Kerstin Markus Ralph Sven Ralph Kerstin Ivonne Stefan Manfred Monika Jürgen Martina Klaus Markus Wolfgang Birgit,e n n s h n h n e n d a n a s s g t,18,15~22,Output: e n n e h p h n e n e n t a n a,234,216,18
Wolfgang Jens Manfred Manfred Stefanie Ute Bernd Klaus Thorsten Ivonne Jutta Philipp Sven Joachim Sabine Sabine Dirk Jürgen Jens Thorsten Karin,g s d d e e d s n e a p n m e e k n s n n,21,15~22,Output: g s d d e e d t e n n b k s n m n,244,225,19
Uwe Ute Rainer Joachim Kerstin Brigitte Thomas Anna Philipp Wolfgang Bärbel Anna Bernd Martina Rainer Manfred,e e r m n e s a p g l a d a r d,16,15~22,Output: e e r n n e t a h e l d a n d r,234,216,18
Susanne Ulrike Jörg Brigitte Stefanie Karin Bärbel Thomas Markus Klaus Markus Sven Monika Jens Sven Jörg Heike Jörg Kerstin,e e g e e n l s s s s n a s n g e g n,19,15~22,Output: e e g e e n s s e n k s n k e,241,224,17
Rainer Thorsten Karin Klaus Jörg Sabine Thomas Jürgen Ralph Bärbel Bernd Bettina Jürgen Jörg Uwe Monika Jürgen Stefan Klaus,r n n s g e s n h l d a n g e a n n s,19,15~22,Output: r n n s g h s l d n g n e n,244,228,16
Karin Bärbel Birgit Susanne Anna Sven Jürgen Monika Rainer Bettina Ulrike Anna Matthias Klaus Anna Jürgen Karin Uwe Martina Bernd,n l t e a n n a r a e a s s a n n e a d,20,15~22,Output: n l t e n e n g n a n k a n a n n a,246,226,20
Matthias Stefanie Stefan Dirk Matthias Anja Heike Philipp Matthias Jan Bernd Katharina Thomas Jan Jan Birgit,s e n k s a e p s n d a s n n t,16,15~22,Output: s e n k t s a e k t n a h t s,226,209,17
Monika Angelika Stefanie Bettina Uwe Katharina Petra Brigitte Rainer Joachim Joachim Wolfgang Stefan Ralph Matthias,a a e a e a a e r m m g n h s,15,15~22,Output: a a e a e e r n m h n,228,215,13
Philipp Klaus Heike Ralph Martina Rainer Kerstin Angelika Jürgen Markus Jörg Ivonne Birgit Wolfgang Anja Rainer Bernd Jutta Brigitte Matthias,p s e h a r n a n s g e t g a r d a e s,20,15~22,Output: p s e h p a r n a k a g n e r b t e,244,224,20
Brigitte Susanne Martina Ulrike Birgit Anna Philipp Uwe Jens Hans Philipp Katharina Birgit Heike Wolfgang Martina Jutta,e e a e t a p e s s p a t e g a a,17,15~22,Output: e e a e t p s h h p a e k e,232,216,16
Bernd Sven Uwe Stefanie Ute Stefan Jürgen Stefanie Jörg Jutta Bärbel Jörg Bärbel Thorsten Dirk Ulrike Rainer Jutta Manfred,d n e e e n n e g a l g l n k e r a d,19,15~22,Output: d n e e n n g e n t e n r e l e,246,228,18
Karin Thorsten Heike Monika Thorsten Markus Martina Bettina Bernd Karin Karin Jutta Ulrike Jan Petra Jens,n n e a n s a a d n n a e n a s,16,15~22,Output: n n e a n n a a a t a a,228,214,14
Monika Stefanie Ralph Wolfgang Bernd Sven Martina Susanne Uwe Martina Bernd Matthias Matthias Jutta Philipp Katharina Jürgen,a e h g d n a e e a d s s a p a n,17,15~22,Output: a e h g d d a e n a a h n a,234,218,16
Jörg Hans Jutta Jürgen Martina Jörg Anja Martina Jan Uwe Stefanie Karin Manfred Stefan Bärbel,g s a n a g a a n e e n d n l,15,15~22,Output: g s a n g a a n a e n a e l,234,218,16
Jan Bettina Manfred Jörg Ralph Bettina Bernd Ralph Bettina Monika Markus Katharina Jutta Ute Bärbel Matthias Ulrike Dirk Ute Manfred,n a d g h a d h a a s a a e l s e k e d,20,15~22,Output: n a d g h d a n a k a a e l e,240,223,17
Hans Stefan Jutta Jan Karin Anja Katharina,s n a n n a a,7,1~8,Output: s n a n a a,206,198,8
Uwe Sabine Jens Stefanie,e e s e,4,1~8,Output: e e s e,199,193,6
Martina Monika,a a,2,1~8,Output: a a,194,190,4
Bettina Hans Manfred Jörg Brigitte Markus Martina,a s d g e s a,7,1~8,Output: a s d g e e a,209,200,9
Wolfgang Sven Bettina Susanne,g n a e,4,1~8,Output: g n a e,199,193,6
Heike Heike,e e,2,1~8,Output: e e,194,190,4
Sabine Angelika Martina Manfred Markus,e a a d s,5,1~8,Output: e a a d s,202,195,7
Jens Ivonne Karin Monika Jan Thomas,s e n a n s,6,1~8,Output: s e n a s s,203,195,8
Ulrike Jürgen Susanne Petra Thomas Ralph Bettina,e n e a s h a,7,1~8,Output: e n e a s h a,208,199,9
Katharina Bettina Manfred,a a d,3,1~8,Output: a a d,198,193,5
Bärbel Kerstin Heike,l n e,3,1~8,Output: l n e,198,193,5
Petra Bettina,a a,2,1~8,Output: a a,193,189,4
Jörg Hans Uwe Jan Stefanie,g s e n e,5,1~8,Output: g s e n e,202,195,7
Bettina Philipp Ulrike,a p e,3,1~8,Output: a p e,196,191,5
Petra Jens Ulrike Petra,a s e a,4,1~8,Output: a s e a,197,191,6
Stefan Thorsten,n n,2,1~8,Output: n n,193,189,4
Wolfgang Manfred Philipp Klaus Angelika Uwe,g d p s a e,6,1~8,Output: g d p s a e,203,195,8
Klaus Martina,s a,2,1~8,Output: s a,193,189,4
Ulrike Anja Sven Jörg Thomas Birgit,e a n g s t,6,1~8,Output: e a n g s,205,198,7
Ivonne Bernd Jürgen Thomas Jörg Klaus,e d n s g s,6,1~8,Output: e d n s s,206,199,7
Jörg Matthias Monika Bärbel Katharina Stefan Anja,g s a l a n a,7,1~8,Output: g s a l a n a,210,201,9
Stefan Anna Brigitte Anna,n a e a,4,1~8,Output: n a e a,198,192,6
Karin Monika Jens Joachim Martina Jutta Jan,n a s m a a n,7,1~8,Output: n a s m a n,207,199,8
Ivonne Anja,e a,2,1~8,Output: e a,194,190,4
Thomas Ralph Jan Petra Susanne,s h n a e,5,1~8,Output: s h n a e,199,192,7
Uwe Ulrike,e e,2,1~8,Output: e e,194,190,4
Ivonne Angelika Ulrike Kerstin,e a e n,4,1~8,Output: e a e n,200,194,6
Kerstin Joachim Stefanie Jan Rainer Monika Kerstin,n m e n r a n,7,1~8,Output: n m e n r a n,209,200,9
Thomas Kerstin Brigitte Jürgen Thorsten,s n e n n,5,1~8,Output: s n e n n,205,198,7
Birgit Katharina Brigitte Hans Uwe Wolfgang Jutta,t a e s e g a,7,1~8,Output: t a e s e o a,209,200,9
Markus Jürgen,s n,2,1~8,Output: s n,195,191,4
Jan Jens Angelika Jan Martina Anja Bettina,n s a n a a a,7,1~8,Output: n s a n a a,205,197,8
Bettina Ulrike Wolfgang Thomas Philipp Martina,a e g s p a,6,1~8,Output: a e g s h a,203,195,8
Sabine Bärbel Thomas Wolfgang Jens,e l s g s,5,1~8,Output: e l s g s,201,194,7
Susanne Bettina,e a,2,1~8,Output: e a,194,190,4
Kerstin Dirk Jörg Manfred Stefanie Susanne,n k g d e e,6,1~8,Output: n k g d e e,206,198,8
Katharina Dirk,a k,2,1~8,Output: a k,194,190,4
Kerstin Rainer Bärbel Heike Jens Dirk Anna,n r l e s k a,7,1~8,Output: n r l e s k a,207,198,9
Sabine Ivonne Matthias Matthias Birgit,e e s s t,5,1~8,Output: e e s s t,201,194,7
Jens Philipp Jan,s p n,3,1~8,Output: s p n,194,189,5
Wolfgang Anja Thomas Ute Ulrike Birgit Jörg,g a s e e t g,7,1~8,Output: g a s e e t g,208,199,9
Dirk Ralph Anna Brigitte Angelika,k h a e a,5,1~8,Output: k h a e a,201,194,7
Wolfgang Bernd Markus Ute Martina Wolfgang Karin,g d s e a g n,7,1~8,Output: g d s e a n g,206,197,9
Birgit Wolfgang,t g,2,1~8,Output: t g,193,189,4
Jens Hans Anja Jutta Anna Karin,s s a a a n,6,1~8,Output: s s a a n,202,195,7
Ivonne Katharina Karin Heike,e a n e,4,1~8,Output: e a n e e,202,195,7
Jan Bernd Thomas,n d s,3,1~8,Output: n d s,195,190,5
Manfred Matthias Thomas Jens Jan,d s s s n,5,1~8,Output: d s s n,198,192,6
Rainer Ute Katharina Ulrike Sven,r e a e n,5,1~8,Output: r e a e e n,205,197,8
Jörg Petra,g a,2,1~8,Output: g a,194,190,4
Katharina Brigitte Jörg Ulrike Kerstin Joachim,a e g e n m,6,1~8,Output: a e g e n m,210,202,8
Birgit Thomas Stefan Manfred Bettina,t s n d a,5,1~8,Output: t s n d a,201,194,7
Sven Monika Stefan Hans Thorsten,n a n s n,5,1~8,Output: n a n s n,201,194,7
Kerstin Dirk Manfred,n k d,3,1~8,Output: n k d,196,191,5
Bernd Rainer Matthias,d r s,3,1~8,Output: d r s,196,191,5
Brigitte Joachim,e m,2,1~8,Output: e m,196,192,4
Bärbel Matthias Birgit Brigitte Jan,l s t e n,5,1~8,Output: l s t e n,203,196,7
Thorsten Anja Kerstin,n a n,3,1~8,Output: n a n,197,192,5
Ralph Jürgen Bettina,h n a,3,1~8,Output: h n a,198,193,5
Bärbel Klaus Dirk Susanne,l s k e,4,1~8,Output: l s k e,199,193,6
Dirk Ulrike,k e,2,1~8,Output: k e,193,189,4
Thorsten Stefanie Philipp Jan Bettina Jan Thomas,n e p n a n s,7,1~8,Output: n e p p a n s,205,196,9
Jens Sven,s n,2,1~8,Output: s n,193,189,4
Stefanie Ralph Wolfgang Stefan Brigitte,e h g n e,5,1~8,Output: e h g n e,201,194,7
Susanne Monika Sabine,e a e,3,1~8,Output: e a e,197,192,5
Thorsten Thorsten,n n,2,1~8,Output: n n,194,190,4
Susanne Katharina Anna Bernd Karin Bernd,e a a d n d,6,1~8,Output: e a a d n d,206,198,8
Manfred Jutta Bettina Bernd Susanne Anja,d a a d e a,6,1~8,Output: d a a d e a,206,198,8
Hans Jutta Heike Bärbel Ralph Jens,s a e l h s,6,1~8,Output: s a e l h s,204,196,8
Dirk Stefan Philipp Petra Angelika,k n p a a,5,1~8,Output: k n p a,198,192,6
Angelika Manfred Monika Bernd,a d a d,4,1~8,Output: a d a d,200,194,6
Jürgen Ivonne Matthias Kerstin Bärbel Manfred,n e s n l d,6,1~8,Output: n e s t n l d,209,200,9
Jan Manfred Matthias Sabine Joachim,n d s e m,5,1~8,Output: n d s e m,202,195,7
Stefan Matthias Brigitte Angelika,n s e a,4,1~8,Output: n s e a,199,193,6
Bernd Ute Jens,d e s,3,1~8,Output: d e s,196,191,5
Dirk Uwe Sabine Jutta Manfred Ralph Angelika Sabine Rainer Wolfgang Thorsten Wolfgang Jörg Bettina Ute Jörg Anja Matthias Wolfgang Bärbel Petra Joachim Markus Anja Thorsten Susanne Monika Bettina,k e e a d h a e r g n g g a e g a s g l a m s a n e a a,28,22~30,Output: k e e a d h a k r n e n e n t n a a n t n a,262,238,24
Katharina Jörg Klaus Manfred Bettina Bärbel Jürgen Brigitte Jens Jens Ute Petra Bärbel Susanne Angelika Katharina Ulrike Anja Bärbel Monika Heike Kerstin Anna Jürgen Bärbel Uwe,a g s d a l n e s s e a l e a a e a l a e n a n l e,26,22~30,Output: a g s d a e e n e e e a a a a e e a e,266,245,21
Thomas Ute Martina Bernd Jörg Rainer Martina Bernd Jörg Manfred Uwe Ulrike Bärbel Bärbel Jürgen Thorsten Ralph Jens Monika Jutta Brigitte Jens Anja Jörg Karin Petra Rainer,s e a d g r a d g d e e l l n n h s a a e s a g n a r,27,22~30,Output: s e a d g r n a d r g n u e l e n t e n a l e,268,243,25
Jan Susanne Ute Thomas Birgit Jürgen Dirk Sabine Susanne Klaus Jutta Brigitte Jan Klaus Jan Bernd Stefan Klaus Jan Ulrike Rainer Sven Birgit Jutta Katharina Heike Sabine Thorsten Sabine,n e e s t n k e e s a e n s n d n s n e r n t a a e e n e,29,22~30,Output: n e e t t n g n e s s e n t t e e e e e e,261,238,23
Anja Anna Matthias Bernd Birgit Sabine Brigitte Bettina Jan Brigitte Jürgen Ivonne Birgit Stefanie Matthias Thorsten Jan Ulrike Wolfgang Karin Wolfgang Dirk,a a s d t e e a n e n e t e s n n e g n g k,22,22~30,Output: a a s d t e e e n e e t e n e,243,226,17
Jan Petra Markus Karin Katharina Anna Jürgen Thomas Hans Bernd Bettina Matthias Kerstin Stefanie Bärbel Manfred Jan Bernd Bettina Rainer Stefanie Heike Bettina Wolfgang,n a s n a a n s s d a s n e l d n d a r e e a g,24,22~30,Output: n a s n a a n g s n d a n d a n e e e,250,229,21
Philipp Manfred Jens Jens Uwe Jutta Bernd Bernd Anna Joachim Brigitte Uwe Philipp Hans Heike Bärbel Joachim Sven Martina Ivonne Wolfgang Bärbel,p d s s e a d d a m e e p s e l m n a e g l,22,22~30,Output: p d s e e d t e n e h e e e e,245,228,17
Dirk Bernd Angelika Anja Birgit Susanne Kerstin Petra Jörg Jutta Petra Katharina Susanne Rainer Thorsten Karin Ulrike Karin Dirk Ivonne Sabine Anna Ute Brigitte Matthias Bettina,k d a a t e n a g a a a e r n n e n k e e a e e s a,26,22~30,Output: k d a a t e n t a e k t a e n e n e e e,257,235,22
Sabine Rainer Monika Jürgen Ralph Angelika Markus Wolfgang Anja Bettina Dirk Birgit Sven Markus Monika Anja Jan Markus Rainer Jan Susanne Sven Philipp Heike Markus Dirk,e r a n h a s g a a k t n s a a n s r n e n p e s k,26,22~30,Output: e r a n g a k s g a n a t t b g a n a k r a i n s s n p h k d,262,229,33
Jan Manfred Jörg Jörg Brigitte Kerstin Karin Sven Jens Klaus Bärbel Karin Susanne Stefanie Philipp Manfred Thomas Uwe Thorsten Markus Jutta Jürgen Markus Angelika Bernd,n d g g e n n n s s l n e e p d s e n s a n s a d,25,22~30,Output: n d g g e t e n s n e e l e n e n t h n,257,235,22
Jörg Manfred Ulrike Stefanie Kerstin Jens Sven Klaus Bettina Dirk Bernd Stefan Birgit Thomas Jan Bettina Manfred Bettina Petra Sven Sven Stefan Bettina Stefan,g d e e n s n s a k d n t s n a d a a n n n a n,24,22~30,Output: g d e e n s s d r d t n a n a t n a n a,248,226,22
Klaus Sven Ivonne Ivonne Anna Katharina Ulrike Rainer Angelika Brigitte Wolfgang Thomas Monika Ute Karin Jürgen Jörg Stefanie Bernd Jutta Philipp Jens Martina Hans Ulrike Heike,s n e e a a e r a e g s a e n n g e d a p s a s e e,26,22~30,Output: s n e e a a e r e t e k a e r t e e e e e,259,236,23
Stefan Anna Karin Bernd Thomas Philipp Jan Ivonne Hans Stefanie Thorsten Thomas Petra Joachim Rainer Ute Susanne Heike Jutta Jürgen Thomas Martina Jutta Markus,n a n d s p n e s e n s a m r e e e a n s a a s,24,22~30,Output: n a n d t p n e h s t t t a e e e n e,248,227,21
Philipp Jens Joachim Petra Birgit Martina Bettina Ute Jan Joachim Ivonne Anja Kerstin Klaus Markus Kerstin Anna Joachim Stefanie Bernd Stefan Ulrike Jutta Hans Ivonne Karin Jürgen Anja,p s m a t a a e n m e a n s s n a m e d n e a s e n n a,28,22~30,Output: p s m a t a e n e n a n k s a n a e h n e n a n k,265,238,27
Jörg Philipp Markus Ulrike Philipp Matthias Karin Philipp Jens Jens Brigitte Ralph Bärbel Stefan Anja Katharina Ralph Ivonne Anna Brigitte Ulrike Thomas Monika Sven Ralph Matthias Stefanie Ivonne,g p s e p s n p s s e h l n a a h e a e e s a n h s e e,28,22~30,Output: g p s e p h g p p e t e r a l e h t n a e t t e r a h t i v e n n a e,270,233,37
Stefanie Brigitte Bettina Stefanie Joachim Monika Bettina Philipp Markus Uwe Bärbel Joachim Heike Bettina Uwe Heike Bettina Heike Ivonne Kerstin Ivonne Jürgen Anja Jürgen,e e a e m a a p s e l m e a e e a e e n e n a n,24,22~30,Output: e e a m h a e n a e e e e n e e e n,260,240,20
Stefan Uwe Ivonne Heike Jutta Bernd Jörg Thorsten Anna Jens Ivonne Sabine Katharina Jens Birgit Martina Karin Ulrike Klaus Monika Thorsten Sabine,n e e e a d g n a s e e a s t a n e s a n e,22,22~30,Output: n e e e t d g n a s e n e n a a e e,247,227,20
Heike Bettina Sven Ralph Heike Kerstin Thorsten Brigitte Karin Rainer Thomas Petra Bernd Manfred Rainer Markus Ute Karin Martina Angelika Sabine Stefan Thomas Kerstin,e a n h e n n e n r s a d d r s e n a a e n s n,24,22~30,Output: e a n h e k n t e t e n a r t e r a n d a,252,229,23
Jürgen Sven Katharina Petra Sabine Bernd Sabine Ivonne Hans Ute Heike Birgit Stefanie Bernd Sabine Markus Rainer Uwe Thomas Ivonne Brigitte Jan,n n a a e d e e s e e t e d e s r e s e e n,22,22~30,Output: n n a a e e d e e e e e e,244,229,15
Jörg Susanne Jürgen Kerstin Kerstin Manfred Jörg Jens Bernd Ute Bernd Klaus Jens Wolfgang Thomas Manfred Ralph Jutta Uwe Petra Bettina Manfred Katharina Katharina Heike Martina,g e n n n d g s d e d s s g s d h a e a a d a a e a,26,22~30,Output: g e n n t d g d d t t a a e e e a a e,258,237,21
Uwe Matthias Ute Dirk Markus Wolfgang Ivonne Martina Monika Sven Brigitte Wolfgang Markus Sven Markus Brigitte Bernd Ulrike Karin Markus Jens Birgit Matthias Jutta Brigitte Heike Karin,e s e k s g e a a n e g s n s e d e n s s t s a e e n,27,22~30,Output: e s e k s g e n e e t e e t e e e e e,254,233,21
Stefan Sabine Sven Birgit Matthias Jan Rainer Bettina Karin Ulrike Wolfgang Bärbel Karin Petra Jens Stefanie Markus Angelika Rainer Petra Anja Karin,n e n t s n r a n e g l n a s e s a r a a n,22,22~30,Output: n e n t s n r a n a a k a a a,240,223,17
Thomas Monika Jens Thomas Petra Jutta Dirk Thomas Jan Ute Birgit Jens Sven Rainer Birgit Jürgen Kerstin Ralph Thomas Ute Ivonne Jan Rainer Rainer Jens,s a s s a a k s n e t s n r t n n h s e e n r r s,25,22~30,Output: s a s s a t a n t s n t e t n e r,245,226,19
Anja Matthias Monika Stefan Angelika Jörg Monika Rainer Martina Susanne Sven Jutta Anna Birgit Markus Katharina Ralph Philipp Dirk Manfred Jörg Ute Uwe Bernd Matthias Monika Jan Ivonne,a s a n a g a r a e n a a t s a h p k d g e e d s a n e,28,22~30,Output: a s a n a k a r n a a t e n a a h t a n d r e d,262,236,26
Rainer Petra Angelika Karin Wolfgang Joachim Jens Matthias Petra Heike Jutta Kerstin Jens Petra Bettina Stefanie Jutta Heike Ralph Thomas Bettina Dirk Sven,r a a n g m s s a e a n s a a e a e h s a k n,23,22~30,Output: r a k n m h k j s p t t h k j p t n a h k r t s,249,223,26
Ivonne Martina Matthias Ivonne Dirk Sven Angelika Bettina Birgit Jürgen Wolfgang Karin Martina Monika Stefanie Jutta Thomas Klaus Bernd Manfred Anja Rainer Anna Uwe Stefan,e a s e k n a a t n g n a a e a s s d d a r a e n,25,22~30,Output: e a s k e n k a g e n a a n d a r t n a,253,231,22
Ivonne Ivonne Ute Uwe Wolfgang Birgit Stefan Anja Brigitte Klaus Susanne Markus Joachim Angelika Stefanie Thorsten Birgit Brigitte Martina Joachim Stefanie Martina Wolfgang Anja Manfred Stefan,e e e e g t n a e s e s m a e n t e a m e a g a d n,26,22~30,Output: e e e e g t e e e e e e e e e e e e e,257,236,21
Klaus Katharina Dirk Katharina Ute Birgit Dirk Sven Markus Kerstin Stefan Birgit Markus Manfred Jürgen Kerstin Ulrike Jens Philipp Matthias Jens Angelika Sven Susanne Ulrike Ute Uwe,s a k a e t k n s n n t s d n n e s p s s a n e e e e,27,22~30,Output: s a k a t a t k s n s t n d r n k s t n s s n e n s s e,264,234,30
Bärbel Petra Thomas Rainer Klaus Anna Rainer Jan Angelika Jutta Ralph Ulrike Monika Martina Philipp Anna Birgit Ralph Jan Stefan Monika Rainer Anja Anna Sabine Sven Anja,l a s r s a r n a a h e a a p a t h n n a r a a e n a,27,22~30,Output: l a s r r n a r n a k a a a t a a a n a e,252,229,23
Martina Stefanie Thomas Birgit Jens Kerstin Ulrike Hans Thorsten Bettina Kerstin Bärbel Joachim Manfred Sabine Klaus Katharina Joachim Jörg Birgit Monika Martina Brigitte Kerstin Birgit Hans Jörg Ivonne Ulrike,a e s t s n e s n a n l m d e s a m g t a a e n t s g e e,29,22~30,Output: a e s t t n e n s t e n t n a e l e n a e e e e e,273,246,27
Thomas Ulrike Matthias Sven Hans Monika Ralph Uwe Jörg Petra Kerstin Ute Dirk Matthias Hans Jan Stefan Birgit Angelika Jörg Sven Angelika Bernd Petra Dirk Jutta Jan Monika,s e s n s a h e g a n e k s s n n t a g n a d a k a n a,28,22~30,Output: s e s s n s e k t r g n a k t n a k t a k,254,231,23
Klaus Sabine Jürgen Stefan Joachim Hans Heike Ivonne Petra Hans Joachim Anna Bernd Matthias Thomas Manfred Jens Angelika Stefanie Bernd Katharina Jens Karin Klaus Philipp Kerstin Kerstin,s e n n m s e e a s m a d s s d s a e d a s n s p n n,27,22~30,Output: s e n n m e k e e a d t s h e n a a d t h a n d k s s n,263,233,30
Heike Jörg Jörg Sven Wolfgang Ute Birgit Ute Joachim Anna Matthias Philipp Stefanie Anja Thomas Ute Stefan Katharina Joachim Dirk Kerstin Kerstin Joachim Ralph Anna Jürgen Jürgen Susanne Stefan,e g g n g e t e m a s p e a s e n a m k n n m h a n n e n,29,22~30,Output: e g g n g e t e n a h c i e n a h n a n a n a n a n,272,244,28
Thomas Bärbel Bernd Matthias Bärbel Anna Jutta Sven Ivonne Katharina Markus Klaus Thorsten Ivonne Jens Wolfgang Martina Ivonne Anja Heike Kerstin Stefanie Martina Dirk Susanne Katharina Stefanie Stefan,s l d s l a a n e a s s n e s g a e a e n e a k e a e n,28,22~30,Output: s l d s a a n e n n e n e n e k e n e n e,260,237,23
Bernd Petra Joachim Ute Thorsten Rainer Stefanie Jens Anna Birgit Philipp Joachim Jutta Stefanie Martina Brigitte Manfred Ulrike Bernd Thomas Joachim Jens Sabine Monika,d a m e n r e s a t p m a e a e d e d s m s e a,24,22~30,Output: d a m e n t r n e e f f i e n t a e e e d,255,232,23
Hans Jens Birgit Philipp Ute Angelika Anja Monika Rainer Thomas Dirk Karin Ivonne Jörg Heike Anja Uwe Joachim Jürgen Klaus Jutta Jens Jan,s s t p e a a a r s k n e g e a e m n s a s n,23,22~30,Output: s s t p e a a k s h e k e i e g n a n,249,228,21
Stefanie Kerstin Manfred Jens Anna Uwe Ivonne Thomas Sabine Jürgen Stefanie Ivonne Jens Ute Dirk Uwe Dirk Monika Wolfgang Kerstin Matthias Bärbel Bettina Joachim Joachim Jutta Petra Heike,e n d s a e e s e n e e s e k e k a g n s l a m m a a e,28,22~30,Output: e n d f a e e n e n k e n d r k e n n a h e n t t e n k e n,270,238,32
Bettina Brigitte Matthias Stefan Jens Thomas Stefanie Monika Klaus Susanne Matthias Susanne Sven Matthias Petra Brigitte Ralph Anna Bettina Matthias Anja Kerstin Anja Monika Katharina Matthias Kerstin,a e s n s s e a s e s e n s a e h a a s a n a a a s n,27,22~30,Output: a e s n s e e e n a e a a a a a,249,231,18
Kerstin Sabine Ute Katharina Stefanie Manfred Brigitte Angelika Bernd Markus Heike Jörg Thorsten Matthias Angelika Bernd Thorsten Anna Kerstin Anna Bärbel Monika Dirk Markus Kerstin Ulrike Jürgen Heike,n e e a e d e a d s e g n s a d n a n a l a k s n e n e,28,22~30,Output: n e e a e e d e k e n n a a l e n a k e n a,266,242,24
Angelika Sven Joachim Jan Anja Klaus Stefanie Joachim Manfred Matthias Jens Thorsten Klaus Ivonne Martina Bernd Bärbel Heike Bärbel Jens Martina Anna Sabine Stefan Sabine Ralph Bettina Joachim Bärbel,a n m n a s e m d s s n s e a d l e l s a a e n e h a m l,29,22~30,Output: a n m n a s h e d e n t e n e n a e e e e e a e,267,241,26
Katharina Ivonne Ralph Stefan Katharina Ivonne Sven Thomas Ulrike Monika Susanne Wolfgang Ulrike Petra Brigitte Heike Angelika Jörg Jürgen Bärbel Klaus Brigitte,a e h n a e n s e a e g e a e e a g n l s e,22,22~30,Output: a e h n a e n s s e k a e e e e e e,252,232,20
Klaus Hans Jens Katharina Sabine Klaus Ulrike Brigitte Joachim Jens Ulrike Ulrike Ulrike Ulrike Ute Stefanie Anja Sabine Susanne Martina Anja Jörg Matthias Jan Jan,s s s a e s e e m s e e e e e e a e e a a g s n n,25,22~30,Output: s s s a e e s m e e e e e e a e e e n n,254,232,22
Stefan Kerstin Klaus Stefanie Hans Martina Anna Birgit Thomas Karin Anna Karin Thomas Joachim Hans Bettina Jens Joachim Brigitte Jörg Martina Rainer Jörg Manfred Karin Wolfgang Karin Sabine,n n s e s a a t s n a n s m s a s m e g a r g d n g n e,28,22~30,Output: n n s s n a n n m t e n t n e e n t e r,259,237,22
Joachim Stefan Stefanie Thomas Jens Birgit Ute Markus Manfred Manfred Jürgen Bettina Martina Hans Birgit Ivonne Susanne Ivonne Heike Karin Martina Ivonne Markus Philipp Thomas Katharina Ulrike Joachim,m n e s s t e s d d n a a s t e e e e n a e s p s a e m,28,22~30,Output: m n e s s t n e k d t n e e n a e e e n a a e,264,239,25
Klaus Hans Wolfgang Susanne Thomas Manfred Bärbel Ute Thomas Hans Markus Martina Ulrike Heike Susanne Jörg Jutta Philipp Bettina Thomas Angelika Hans Thomas Jens Ulrike Jürgen,s s g e s d l e s s s a e e e g a p a s a s s s e n,26,22~30,Output: s s g e s s d l e e a e k a e e e n e,251,230,21
Dirk Uwe Karin Stefan Sabine Anja Rainer Wolfgang Petra Matthias Martina Bärbel Petra Hans Bettina Bärbel Bärbel Hans Hans Jan Jan Karin,k e n n e a r g a s a l a s a l l s s n n n,22,22~30,Output: k e n n a e r a a e n a a l a n a,241,222,19
Ulrike Sven Kerstin Karin Jan Klaus Sabine Susanne Thomas Jutta Klaus Stefanie Monika Brigitte Thomas Angelika Matthias Joachim Markus Martina Kerstin Thorsten Bettina Monika Brigitte,e n n n n s e e s a s e a e s a s m s a n n a a e,25,22~30,Output: e n n n e s s e h n a e e e n a h n e t e n a,257,232,25
Susanne Markus Anja Bettina Manfred Anja Sven Klaus Anna Monika Katharina Wolfgang Heike Angelika Stefan Joachim Jörg Jan Matthias Jan Jürgen Jutta Ralph,e s a a d a n s a a a g e a n m g n s n n a h,23,22~30,Output: e s a a d d a n k a a h e k a n m h m n n g n,253,228,25
Matthias Martina Markus Markus Monika Ulrike Ralph Birgit Brigitte Ute Susanne Philipp Angelika Kerstin Joachim Hans Thomas Sven Bettina Markus Thomas Dirk Karin Anja Ute Uwe Monika Matthias,s a s s a e h t e e e p a n m s s n a s s k n a e e a s,28,22~30,Output: s a s k a e h t e g t e n e t e n a k a n a e e e,260,233,27
Manfred Stefan Thorsten Jens Dirk Markus Jörg Sabine Katharina Wolfgang Sven Anna Angelika Wolfgang Philipp Birgit Jürgen Jörg Stefanie Petra Monika Dirk Kerstin Philipp Joachim Manfred Petra Uwe,d n n s k s g e a g n a a g p t n g e a a k n p m d a e,28,22~30,Output: d n n k s g e d a a g n e e n a n k t n a n d,261,236,25
Jörg Susanne Ralph Jürgen Ralph Jan Jens Manfred Sabine Wolfgang Hans Thomas Wolfgang Stefanie Jens Angelika Dirk Rainer Susanne Sabine Martina Hans Jörg Martina Sabine,g e h n h n s d e g s s g e s a k r e e a s g a e,25,22~30,Output: g e h g n j s d e f e n a n a e n a e,250,229,21
Kerstin Dirk Brigitte Jutta Monika Bärbel Bärbel Jürgen Dirk Uwe Manfred Ivonne Anja Bernd Brigitte Petra Susanne Katharina Stefanie Karin Angelika Bettina Susanne Rainer Markus Martina Bettina,n k e a a l l n k e d e a d e a e a e n a a e r s a a,27,22~30,Output: n k e e a l e n n e n d e e e a a a a a a a,267,243,24
Katharina Ute Dirk Rainer Uwe Klaus Susanne Markus Bettina Klaus Dirk Bärbel Jürgen Monika Angelika Uwe Jörg Stefanie Jutta Rainer Jürgen Uwe Thorsten Jörg Martina Stefanie Monika,a e k r e s e s a s k l n a a e g e a r n e n g a e a,27,22~30,Output: a e k r e s s e n k l s a n k l b l g n k a a e e n a,272,243,29
Bernd Heike Sabine Karin Hans Thorsten Ute Jens Heike Susanne Ralph Manfred Jan Ralph Uwe Joachim Manfred Thomas Wolfgang Jörg Jan Thorsten Monika Bärbel Anna Sven Jörg,d e e n s n e s e e h d n h e m d s g g n n a l a n g,27,22~30,Output: d e e n s n e k t e e n e d r f d m d t h g n k e n,263,235,28
Thomas Sabine Martina Anja Jürgen Klaus Susanne Wolfgang Hans Ulrike Klaus Ralph Jutta Bernd Susanne Stefan Martina Jens Birgit Uwe Heike Kerstin Bernd Wolfgang Monika,s e a a n s e g s e s h a d e n a s t e e n d g a,25,22~30,Output: s e a a n s g e n s s n d t e k s s n a n d,253,229,24
Markus Jutta Ralph Katharina Jutta Heike Brigitte Wolfgang Anja Jürgen Jan Birgit Susanne Anja Ivonne Kerstin Birgit Ivonne Sven Philipp Joachim Karin Markus,s a h a a e e g a n n t e a e n t e n p m n s,23,22~30,Output: s a h a a e e e n e n e n n n,248,231,17
Angelika Kerstin Bärbel Kerstin Uwe Thomas Jürgen Kerstin Sven Jürgen Ivonne Jörg Anja Bettina Thorsten Manfred Philipp Matthias Stefanie Matthias Uwe Monika Karin Birgit Birgit Sabine,a n l n e s n n n n e g a a n d p s e s e a n t t e,26,22~30,Output: a n l e e s n n e n e n a n t n a t t e n a,264,240,24
Wolfgang Martina Anja Wolfgang Ralph Stefanie Jan Markus Anna Uwe Martina Jörg Bärbel Markus Angelika Bärbel Stefanie Ulrike Angelika Dirk Kerstin Rainer Ulrike Jutta Joachim Uwe Uwe,g a a g h e n s a e a g l s a l e e a k n r e a m e e,27,22~30,Output: g a a h e e e a a l e k a a e k e n e e e,259,236,23
Ulrike Jörg Anna Jan Ivonne Anja Jürgen Karin Petra Monika Birgit Manfred Jan Philipp Rainer Susanne Jan Thomas Susanne Markus Jürgen Jens,e g a n e a n n a a t d n p r e n s e s n s,22,22~30,Output: e g a n e n a n g e r a n d r a n s e n,248,226,22
Matthias Uwe Jutta Stefan Sven Anna Ute Rainer Hans Jörg Jutta Manfred Philipp Susanne Anja Klaus Jan Petra Hans Anna Markus Stefan,s e a n n a e r s g a d p e a s n a s a s n,22,22~30,Output: s e a n r e r t a n a d r a n a h s,239,219,20
Hans Jörg Jörg Angelika Matthias Anna Anja Ulrike Stefan Wolfgang Hans Ivonne Bettina Stefanie Angelika Birgit Anja Susanne Thomas Thorsten Ivonne Manfred Susanne Anna Stefanie Stefan Jens,s g g a s a a e n g s e a e a t a e s n e d e a e n s,27,22~30,Output: s g a a a e e l e n a n t n e e e n a e e n a e,258,232,26
Sven Ute Bernd Thomas Petra Ute Ivonne Ivonne Joachim Hans Philipp Bärbel Jörg Hans Brigitte Bernd Petra Anna Katharina Heike Angelika Joachim Anna Katharina Ivonne Sven,n e d s a e e e m s p l g s e d a a a e a m a a e n,26,22~30,Output: n e d s a e n e e m h e e e e a a a e e a,260,237,23
Bernd Wolfgang Jürgen Kerstin Martina Bernd Hans Kerstin Rainer Karin Angelika Kerstin Ulrike Rainer Ute Stefanie Jens Angelika Birgit Anna Karin Anna Uwe Ivonne,d g n n a d s n r n a n e r e e s a t a n a e e,24,22~30,Output: d g n n a d s n a k a a e e e e,249,231,18
Anja Monika Ralph Brigitte Anna Jens Stefanie Joachim Jens Angelika Philipp Klaus Bärbel Klaus Brigitte Anja Jörg Thomas Ulrike Ute Joachim Anna Manfred Ivonne Markus Sven Anja,a a h e a s e m s a p s l s e a g s e e m a d e s n a,27,22~30,Output: a a h e e n e m h e n s s l e n a l e k s e n a a g,264,236,28
Angelika Markus Kerstin Stefanie Markus Jutta Anja Ulrike Katharina Anna Uwe Thomas Thomas Stefanie Jan Birgit Markus Ralph Petra Thorsten Sabine Manfred,a s n e s a a e a a e s s e n t s h a n e d,22,22~30,Output: a s n e e a a e a h e n a n d e n a,242,222,20
Joachim Markus Ute Karin Anna Philipp Ulrike Stefanie Thorsten Ralph Sven Bernd Jens Susanne Bernd Jens Wolfgang Ralph Uwe Brigitte Joachim Bettina Martina,m s e n a p e e n h n d s e d s g h e e m a a,23,22~30,Output: m s e n a p e e d n e s s n e d t e n e,249,227,22
Jürgen Ivonne Ivonne Bernd Anna Hans Manfred Petra Klaus Bernd Anna Dirk Dirk Anna Joachim Dirk Hans Thorsten Dirk Brigitte Kerstin Philipp Wolfgang Manfred Wolfgang,n e e d a s d a s d a k k a m k s n k e n p g d g,25,22~30,Output: n e e d n a d k s s t n e t e n t e n t n e,250,226,24
Jörg Bettina Uwe Heike Bernd Matthias Ulrike Rainer Bärbel Ulrike Karin Bärbel Ralph Klaus Angelika Stefan Heike Rainer Brigitte Martina Jutta Ulrike Uwe Ivonne Stefan Hans Thorsten Uwe Manfred,g a e e d s e r l e n l h s a n e r e a a e e e n s n e d,29,22~30,Output: g a e e d l e r n e l e k a l e n a k a h t e n e e e n e,273,242,31
Sven Jürgen Sven Kerstin Susanne Klaus Jan Jan Bernd Rainer Brigitte Jutta Ralph Martina Manfred Dirk Ulrike Matthias Uwe Jürgen Uwe Karin,n n n n e s n n d r e a h a d k e s e n e n,22,22~30,Output: n n n n s s s n t e e e e e,245,229,16
Bettina Martina Dirk Kerstin Sven Stefan Joachim Ivonne Wolfgang Katharina Brigitte Rainer Angelika Birgit Susanne Bernd Uwe Uwe Bärbel Angelika Dirk Kerstin Joachim Ivonne,a a k n n n m e g a e r a t e d e e l a k n m e,24,22~30,Output: a a k n n m h e k a e t e e e t e k a,256,235,21
Sven Jörg Ute Jutta Brigitte Monika Martina Stefanie Matthias Stefan Uwe Jens Brigitte Thorsten Rainer Dirk Monika Philipp Ivonne Martina Bärbel Joachim Dirk Angelika Manfred Philipp,n g e a e a a e s n e s e n r k a p e a l m k a d p,26,22~30,Output: n g e e e e n a n e n t n a k a n d r e n a,260,236,24
Bernd Ralph Jörg Anja Sabine Jens Philipp Thorsten Angelika Klaus Katharina Jan Stefanie Stefanie Petra Sabine Bärbel Jutta Sabine Monika Rainer Jan Karin Katharina Ivonne,d h g a e s p n a s a n e e a e l a e a r n n a e,25,22~30,Output: d h g a e n s s t n a k a a e e e e a e,255,233,22
Manfred Stefanie Petra Ute Stefan Ute Anja Ivonne Monika Ralph Ralph Ulrike Kerstin Ralph Matthias Manfred Manfred Jan Markus Sven Petra Matthias,d e a e n e a e a h h e n h s d d n s n a s,22,22~30,Output: d e a e n a e h e e n a h t e n a h,240,220,20
Katharina Stefanie Jürgen Jutta Petra Stefanie Rainer Heike Jan Kerstin Hans Joachim Wolfgang Markus Jürgen Sabine Jürgen Birgit Rainer Jutta Sabine Ulrike Bettina Bärbel Uwe,a e n a a e r e n n s m g s n e n t r a e e a l e,25,22~30,Output: a e n a e e e k e m h m b r n e e e e,261,240,21
Monika Sven Brigitte Kerstin Thomas Matthias Stefan Ulrike Anja Dirk Jutta Sabine Anja Rainer Klaus Hans Sven Sabine Manfred Jutta Thomas Markus Sabine Anna Stefanie Sabine Petra Birgit Sven,a n e n s s n e a k a e a r s s n e d a s s e a e e a t n,29,22~30,Output: a n e t s h c e s a a r n e e e e t e,256,235,21
Matthias Jutta Brigitte Katharina Thorsten Jutta Thorsten Susanne Thorsten Jens Anja,s a e a n a n e n s a,11,8~15,Output: s a e a n n e n s s a,221,208,13
Sabine Angelika Ivonne Petra Karin Bärbel Jan Thorsten,e a e a n l n n,8,8~15,Output: e a e a n l n,210,201,9
Thorsten Thorsten Anja Jörg Markus Katharina Markus Ivonne Klaus Angelika,n n a g s a s e s a,10,8~15,Output: n n a g s s e a,215,205,10
Ralph Wolfgang Karin Manfred Sven Kerstin Manfred Manfred Jens Monika Thomas Stefanie Angelika Dirk,h g n d n n d d s a s e a k,14,8~15,Output: h g n d d s t e a k a h,223,209,14
Ralph Birgit Karin Klaus Ralph Ute Anja Heike Katharina Heike Stefan Kerstin Ivonne,h t n s h e a e a e n n e,13,8~15,Output: h t n s h e e e n,220,209,11
Monika Rainer Jan Brigitte Ivonne Ute Philipp Philipp Heike Uwe,a r n e e e p p e e,10,8~15,Output: a r n e e e e,213,204,9
Jürgen Dirk Matthias Monika Joachim Kerstin Anna Katharina Jörg Jörg Jens,n k s a m n a a g g s,11,8~15,Output: n k s a m n a a g s,222,210,12
Manfred Klaus Rainer Jürgen Uwe Jan Petra Sabine Jörg Ulrike Kerstin Jan Anna,d s r n e n a e g e n n a,13,8~15,Output: d s r n e n e e n a,222,210,12
Anna Monika Thomas Petra Jutta Jürgen Kerstin Bernd Bärbel Susanne Jan,a a s a a n n d l e n,11,8~15,Output: a a s a t n n d l,218,207,11
Ralph Matthias Birgit Monika Bernd Joachim Stefanie Anna Matthias,h s t a d m e a s,9,8~15,Output: h s t g n m e h,211,201,10
Thomas Ute Angelika Bettina Angelika Ivonne Kerstin Sabine Brigitte Bettina Joachim Brigitte,s e a a a e n e e a m e,12,8~15,Output: s e a a e n e e t e,224,212,12
Jan Dirk Philipp Manfred Petra Katharina Bettina Jörg Jörg Brigitte Hans Wolfgang,n k p d a a a g g e s g,12,8~15,Output: n k p d a n a g e t e,221,208,13
Ralph Rainer Matthias Ulrike Susanne Jens Angelika Birgit Stefanie,h r s e e s a t e,9,8~15,Output: h r s e e s t e,211,201,10
Joachim Klaus Monika Markus Philipp Anna Klaus Klaus Anna Anna Kerstin Monika Sabine,m s a s p a s s a a n a e,13,8~15,Output: m s a k s a a n a a n e,219,205,14
Ute Stefan Sabine Jan Bärbel Dirk Bernd Stefanie Birgit Angelika Jürgen,e n e n l k d e t a n,11,8~15,Output: e n e e l d t e k a,220,208,12
Jörg Stefan Heike Philipp Hans Bärbel Stefanie Stefan Manfred Uwe Birgit,g n e p s l e n d e t,11,8~15,Output: g n e p s n d e e,217,206,11
Monika Philipp Ivonne Jörg Birgit Jens Manfred Uwe Bernd Jörg Ulrike Petra,a p e g t s d e d g e a,12,8~15,Output: a p e n g t d e d e a,222,209,13
Anja Hans Stefan Sabine Bärbel Thomas Rainer Jutta Uwe,a s n e l s r a e,9,8~15,Output: a s n e l s h a e,213,202,11
Bernd Bärbel Dirk Philipp Stefan Jutta Jürgen Ralph,d l k p n a n h,8,8~15,Output: d l k n n g n,210,201,9
Uwe Brigitte Uwe Martina Jutta Brigitte Anja Stefanie Dirk Dirk Uwe Thorsten Karin,e e e a a e a e k k e n n,13,8~15,Output: e e e a a e e k n,223,212,11
Markus Anja Jürgen Markus Rainer Wolfgang Ulrike Stefan Petra Jan Dirk Ralph Thomas Manfred,s a n s r g e n a n k h s d,14,8~15,Output: s a n s r g e n a n d r a h m,224,207,17
Markus Monika Manfred Jürgen Wolfgang Rainer Petra Stefanie Joachim,s a d n g r a e m,9,8~15,Output: s a d n g l e m,214,204,10
Sven Philipp Katharina Kerstin Anna Ute Dirk Heike Jutta Karin Bärbel Dirk Sven Sven,n p a n a e k e a n l k n n,14,8~15,Output: n p a n a e k e e k l b l k,228,212,16
Anja Martina Ivonne Joachim Martina Sabine Birgit Thomas Jutta Ute Sven Rainer Bärbel Klaus,a a e m a e t s a e n r l s,14,8~15,Output: a a e m a e t a s t u n r l,230,214,16
Philipp Susanne Bettina Bärbel Birgit Birgit Rainer Thomas Karin Joachim Uwe,p e a l t t r s n m e,11,8~15,Output: p e a l t t r n m,219,208,11
Jörg Jens Angelika Anja Susanne Monika Birgit Jutta Thomas Anja Philipp Uwe Philipp Matthias,g s a a e a t a s a p e p s,14,8~15,Output: g s a a e k a t a a p p h,225,210,15
Klaus Monika Stefan Sabine Manfred Bernd Uwe Matthias,s a n e d d e s,8,8~15,Output: s a n e d n d e,209,199,10
Jan Susanne Wolfgang Katharina Sabine Birgit Philipp Klaus Anna Petra Dirk Jens Anja,n e g a e t p s a a k s a,13,8~15,Output: n e g a e t t p a k s a,219,205,14
Manfred Anja Uwe Thorsten Markus Thorsten Monika Matthias Jan Karin,d a e n s n a s n n,10,8~15,Output: d a e n n s n a k,214,203,11
Philipp Stefan Brigitte Karin Thorsten Joachim Bernd Wolfgang Susanne Matthias Jürgen Philipp,p n e n n m d g e s n p,12,8~15,Output: p n e n n m h g n,220,209,11
Bärbel Jens Dirk Monika Bettina Kerstin Katharina Matthias Markus Jutta Dirk Anja Brigitte,l s k a a n a s s a k a e,13,8~15,Output: l s k a a n a h t e,222,210,12
Bettina Klaus Stefan Joachim Hans Angelika Ivonne Uwe,a s n m s a e e,8,8~15,Output: a s n m s a e,209,200,9
Thomas Sven Angelika Thomas Sven Joachim Brigitte Thomas Wolfgang,s n a s n m e s g,9,8~15,Output: s n a s n m e thomas,213,202,11
Heike Stefanie Kerstin Heike Petra Jörg Hans Anja,e e n e a g s a,8,8~15,Output: e e n e a g s,210,201,9
Birgit Stefanie Thomas Klaus Heike Ulrike Anna Ivonne Philipp Wolfgang Stefan,t e s s e e a e p g n,11,8~15,Output: t e s s u e a e n p h,215,202,13
Bettina Joachim Thomas Anja Sven Ulrike Uwe Katharina Anja Ute Susanne Brigitte Jan Ute,a m s a n e e a a e e e n e,14,8~15,Output: a m s a n e e a e e e,228,215,13
Karin Dirk Dirk Stefanie Wolfgang Markus Sabine Joachim Heike Sven Angelika Klaus,n k k e g s e m e n a s,12,8~15,Output: n k r e g n m e e k s a,220,206,14
Matthias Markus Stefanie Matthias Ivonne Jutta Sabine Ulrike Ralph Anja Stefan Sven Karin Angelika,s s e s e a e e h a n n n a,14,8~15,Output: s s e e a a e e n a,221,209,12
Bärbel Anna Jutta Katharina Wolfgang Klaus Hans Markus Jörg Birgit Philipp,l a a a g s s s g t p,11,8~15,Output: l a a n a g s k s t,217,205,12
Heike Monika Markus Thomas Monika Bettina Anna Katharina Kerstin Ivonne Anja Monika Bettina Sven,e a s s a a a a n e a a a n,14,8~15,Output: e a s s a a n a e n a,225,212,13
Manfred Ulrike Sabine Thorsten Katharina Kerstin Angelika Katharina Jan Hans,d e e n a n a a n s,10,8~15,Output: d e e n n a a n s,217,206,11
Jan Wolfgang Joachim Philipp Kerstin Hans Markus Rainer Karin Jörg Sven Sven,n g m p n s s r n g n n,12,8~15,Output: n g m p n s n r n g,219,207,12
Sabine Bärbel Kerstin Stefan Sabine Rainer Bernd Hans Heike Susanne Jutta Jörg Angelika Heike,e l n n e r d s e e a g a e,14,8~15,Output: e l n n n r d e e a k a,228,214,14
Ulrike Bärbel Thomas Philipp Hans Thorsten Bernd Susanne Sven Bettina Angelika Brigitte Anna,e l s p s n d e n a a e a,13,8~15,Output: e l s h p s n d e e a,223,210,13
Bernd Hans Stefanie Hans Ivonne Ivonne Philipp Dirk Monika Rainer Susanne Jens,d s e s e e p k a r e s,12,8~15,Output: d s e e e n k a r e n e,219,205,14
Klaus Philipp Hans Matthias Bernd Bernd Joachim Rainer Ivonne Susanne Karin,s p s s d d m r e e n,11,8~15,Output: s p s t d d m h n e e,218,205,13
Bernd Birgit Monika Klaus Susanne Thomas Thomas Monika Rainer Markus Bärbel Anna Manfred,d t a s e s s a r s l a d,13,8~15,Output: d t a s e s s a n d,220,208,12
Stefanie Sabine Bärbel Stefanie Thomas Joachim Anna Bärbel Heike Bettina Philipp,e e l e s m a l e a p,11,8~15,Output: e e l h s m e k e a,220,208,12
Ralph Ute Jörg Ralph Joachim Stefan Bernd Hans Jutta,h e g h m n d s a,9,8~15,Output: h e g h m d s a,212,202,10
Thorsten Ute Uwe Ulrike Monika Thomas Joachim Ute Hans Jörg,n e e e a s m e s g,10,8~15,Output: n e e e a s m h g,217,206,11
Jutta Ulrike Philipp Thorsten Karin Petra Manfred Manfred Matthias Jutta Katharina Manfred Susanne,a e p n n a d d s a a d e,13,8~15,Output: a e p n a a d t a a a e,224,210,14
Katharina Birgit Ivonne Jörg Dirk Martina Anna Bärbel Ivonne Bernd Uwe Klaus Uwe,a t e g k a a l e d e s e,13,8~15,Output: a t e g k a a l e d e u e,227,212,15
Klaus Martina Klaus Joachim Hans Katharina Monika Stefan Bärbel Bernd Klaus,s a s m s a a n l d s,11,8~15,Output: s a s h n a k l d,217,206,11
Thomas Bärbel Thorsten Markus Bärbel Thomas Dirk Ivonne,s l n s l s k e,8,8~15,Output: s l n s l s k e,210,200,10
Katharina Susanne Ralph Martina Klaus Bärbel Jörg Bärbel Klaus,a e h a s l g l s,9,8~15,Output: a e h a n l b l,215,205,10
Ulrike Angelika Jan Bärbel Anna Ulrike Jürgen Jens Ulrike,e a n l a e n s e,9,8~15,Output: e a n l e a n n e n,216,204,12
Ute Heike Anna Klaus Susanne Anja Angelika Bettina Brigitte Klaus Bärbel Stefan,e e a s e a a a e s l n,12,8~15,Output: e e a s e a a e l n,220,208,12
Angelika Bettina Sven Matthias Katharina Kerstin Brigitte Markus Bernd Karin,a a n s a n e s d n,10,8~15,Output: a a n s a n e t e,217,206,11
Ute Jutta Ralph Rainer Thomas Heike Joachim Susanne,e a h r s e m e,8,8~15,Output: e a h r s e m,210,201,9
Martina Katharina Jörg Kerstin Wolfgang Sven Kerstin Manfred Ivonne Sabine Rainer Martina Monika Dirk,a a g n g n n d e e r a a k,14,8~15,Output: a a g n e g n e e e r a a k,230,214,16
Heike Jutta Stefanie Markus Jörg Monika Jörg Manfred Bärbel Dirk Bärbel Philipp,e a e s g a g d l k l p,12,8~15,Output: e a e s g g d l b l p,224,211,13
Thorsten Karin Heike Bärbel Manfred Ulrike Birgit Ute Bettina Birgit Kerstin,n n e l d e t e a t n,11,8~15,Output: n n e l d e t e n a,221,209,12
Bernd Manfred Ivonne Jürgen Susanne Anna Bettina Jürgen Sven,d d e n e a a n n,9,8~15,Output: d d e n n e a n n,218,207,11
Sabine Hans Martina Thorsten Wolfgang Birgit Joachim Philipp Jens Markus Jürgen Thorsten Philipp Heike,e s a n g t m p s s n n p e,14,8~15,Output: e s n n g t t n n g e k e,226,211,15
Kerstin Hans Klaus Katharina Bärbel Anja Katharina Petra Anja Heike Ulrike Sven Karin,n s s a l a a a a e e n n,13,8~15,Output: n s s a n a a e k e,224,212,12
Anja Thomas Hans Heike Kerstin Philipp Wolfgang Katharina Thorsten Heike Bettina,a s s e n p g a n e a,11,8~15,Output: a s s e e n g a e e a,218,205,13
Heike Philipp Birgit Brigitte Brigitte Klaus Stefanie Ivonne Wolfgang Jan Susanne Markus,e p t e e s e e g n e s,12,8~15,Output: e p t e e e s e n e,219,207,12
Susanne Sven Birgit Heike Ulrike Anja Susanne Philipp Susanne Brigitte Katharina,e n t e e a e p e e a,11,8~15,Output: e n t e e a e e e,220,209,11
Ralph Katharina Susanne Bettina Kerstin Manfred Stefan Jürgen Sabine Bärbel Jan,h a e a n d n n e l n,11,8~15,Output: h a e a n d n e n e l,222,209,13
Hans Birgit Anna Karin Jutta Hans Hans Bernd Bärbel Monika Uwe Angelika,s t a n a s s d l a e a,12,8~15,Output: s t a n a t s d l a,219,207,12
Bärbel Martina Hans Jutta Kerstin Uwe Anna Brigitte,l a s a n e a e,8,8~15,Output: l a s a a e,210,202,8
Anja Sven Dirk Uwe Jan Ivonne Thomas Martina Martina Rainer Joachim Bettina,a n k e n e s a a r m a,12,8~15,Output: a n k e e n a n r n a,221,208,13
Stefan Philipp Karin Rainer Rainer Stefanie Ulrike Brigitte Birgit Thorsten Jürgen Ivonne,n p n r r e e e t n n e,12,8~15,Output: n p n r r e e t e t e n,225,211,14
Joachim Thomas Matthias Wolfgang Klaus Markus Uwe Thomas Bärbel Anja Jörg Jan Petra,m s s g s s e s l a g n a,13,8~15,Output: m s h g s k s a g n,219,207,12
Dirk Katharina Rainer Manfred Stefan Kerstin Rainer Philipp Jürgen,k a r d n n r p n,9,8~15,Output: k a r d n a n r g,215,204,11
