input,out,len,bins,pred,total-tokens,prompt-tokens,completion-tokens
Ethan Amelia Alexander Layla Samuel Amelia Elias Isabella Joseph Mia Naomi Isabella Ellie Zoe Ethan,n a r a l a s a h a i a e e n,15,15~22,Output: n a r a l a s a h a i a e e n,212,195,17
Noah Michael Hazel Evelyn Scarlett Ivy John Aria Samuel David Ella Alexander Harper Emilia Ezra Michael Theodore Owen Isaac Amelia,h l l n t y n a l d a r r a a l e n c a,20,15~22,Output: h l l n t y n a l d a r r a a l e e n c a,222,199,23
Thomas Santiago Mia Hazel Elijah Thomas Eleanor Grayson Aurora Santiago Luna Matthew Isaac Ella Elias Daniel,s o a l h s r n a o a w c a s l,16,15~22,Output: s o a l h s r n a o a w c a s l,212,194,18
Isaac Riley Liam Thomas Hudson Mila Joseph Matthew Aria Mateo Harper Ellie Jack John Nora Grayson Sebastian,c y m s n a h w a o r e k n a n n,17,15~22,Output: c y m s n a h w a o r e k n a n n,217,198,19
Alexander Lucy Grayson Ellie Ezra Levi Ellie Nora Isla Grayson Thomas Owen Aria Avery Elias,r y n e a i e a a n s n a y s,15,15~22,Output: r y n e a i e a a n s n a y s,213,196,17
Avery Abigail Grayson James Jack Willow Ava David Emma Penelope Jacob Ava Julian Charlotte Grayson,y l n s k w a d a e b a n e n,15,15~22,Output: y l n s k w a d a e b a n e n,213,196,17
Eliana Zoe Sophia William Aria Logan Evelyn Layla John Penelope Isaac Grayson Abigail Naomi Julian Matthew Hazel Joseph Riley,a e a m a n n a n e c n l i n w l h y,19,15~22,Output: a e a m a n n a n e c n l i n w l h h y,224,202,22
Michael Asher Emily Luca David Evelyn Lucy Santiago Benjamin Thomas Lucy Chloe Liam Sofia Lucy Lily,l r y a d n y o n s y e m a y y,16,15~22,Output: l r y a d n y o n s y e m a y y,212,194,18
Henry Benjamin Avery Benjamin Daniel Nova Harper Hudson Asher Theodore Chloe Elizabeth Daniel Elizabeth Gabriel Riley Sofia,y n y n l a r n r e e h l h l y a,17,15~22,Output: y n y n l a r n r e e h l h l y a,214,195,19
Emily Ellie Luca Henry Willow Owen Charlotte Aurora Logan Willow Eleanor Levi Santiago Abigail Jack Hazel Sophia Charlotte,y e a y w n e a n w r i o l k l a e,18,15~22,Output: y e a y w n e a n w r i o l k l a e,216,196,20
Mateo Grace Alexander Isla Avery Eliana Owen William Isaac Abigail Lucas Luca Ethan John Zoe Levi Lucy Gianna,o e r a y a n m c l s a n n e i y a,18,15~22,Output: o e r a y a n m c l s a n n e i y a,220,200,20
Camila Ava Mason Ezra Olivia Victoria Abigail Amelia Willow Leo Jackson Sophia Maverick Maverick Alexander Benjamin Charlotte Noah Mateo Julian,a a n a a a l a w o n a k k r n e h o n,20,15~22,Output: a a n a a a l a w o n a k k r n e o h n,224,202,22
Madison William Miles Camila Henry Penelope Alexander Ivy Emily Jackson Madison Evelyn Grace Oliver Violet Jacob,n m s a y e r y y n n n e r t b,16,15~22,Output: n m s a y e r y y n n n e r t b,213,195,18
Levi Emily Hazel Samuel Benjamin Naomi Aurora Lucy Daniel Samuel David Levi Nora Leo Luna,i y l l n i a y l l d i a o a,15,15~22,Output: i y l l n i a y l l d i a o a,209,192,17
Michael Willow Charlotte Benjamin Thomas Asher Ivy Charlotte Jackson Victoria Gabriel Lucy Abigail Jackson Henry,l w e n s r y e n a l y l n y,15,15~22,Output: l w e n s r y e n a l y n y,210,194,16
Grayson Violet Evelyn Matthew Chloe Sofia Santiago Benjamin Isla Willow Camila Ezra William Victoria Emily,n t n w e a o n a w a a m a y,15,15~22,Output: n t n w e a o n a w a a m a y,212,195,17
Aurora Henry Maverick Grayson Lily Sebastian Nova Grace James Camila John Chloe Chloe Maverick Gianna Gianna Lucas Elias Elizabeth,a y k n y n a e s a n e e k a a s s h,19,15~22,Output: a y k n y n a e s a n e e k a a s s h,223,202,21
Layla Alexander Emily Evelyn Ella Logan Gabriel William Zoe Hazel Elijah Oliver David Riley Sophia Lucy Olivia Zoe Lily Victoria Nova,a r y n a n l m e l h r d y a y a e y a a,21,15~22,Output: a r y n a n l m e l h r d y a y a e y a a,222,199,23
Harper James Sophia Nora Samuel Lily Gianna Gianna Thomas Charlotte Ivy Eleanor Emily Abigail Logan Mia Ezra Lily,r s a a l y a a s e y r y l n a a y,18,15~22,Output: r s a a l y a a s e y r y l n a a y,218,198,20
Layla Daniel Lily Eleanor Avery Riley Avery Evelyn Benjamin Naomi James Evelyn Aiden Henry Levi Ellie Ethan Liam Lucy Nora Isaac,a l y r y y y n n i s n n y i e n m y a c,21,15~22,Output: a l y r y y y n n i s n n y i e n m y a c,223,200,23
Avery Santiago Riley Layla Aurora Ella Emma Benjamin Riley Olivia Evelyn Ezra Thomas Zoe Noah Gabriel Ezra Elijah Aiden Willow,y o y a a a a n y a n a s e h l a h n w,20,15~22,Output: y o y a a a a n y a n a s e h l a n w,220,199,21
Luca Emily Isla Abigail Isabella Lucas Violet Elias Hudson Madison Lily Maverick Aiden Oliver Chloe Sebastian Julian Santiago,a y a l a s t s n n y k n r e n n o,18,15~22,Output: a y a l a s t s n n y k n r e n o,219,200,19
Logan Nova Abigail Olivia Abigail Emma Aurora Michael Ella Isla Benjamin Joseph Eleanor Theodore Michael Aria Layla Luca,n a l a l a a l a a n h r e l a a a,18,15~22,Output: n a l a l a a l a a n h r e l a a a,220,200,20
Owen Jacob Emilia Naomi Penelope Levi Sebastian Ethan Lucas Emily Chloe Eleanor Eleanor Amelia Oliver,n b a i e i n n s y e r r a r,15,15~22,Output: n b a i e i n n s y e r r a r,211,194,17
Theodore Chloe Alexander Asher Michael Elizabeth Hazel Ellie Maverick Hazel Benjamin Lucas Chloe Aiden Abigail Elias Naomi Aiden Grayson Aria,e e r r l h l e k l n s e n l s i n n a,20,15~22,Output: e e r r l h l e k l n s e n l s i n n n a,227,204,23
Levi Hazel Elias Noah Violet Emily Abigail Zoe Isla Theodore Thomas Elizabeth Gianna Alexander Noah Mason Matthew Elijah Levi,i l s h t y l e a e s h a r h n w h i,19,15~22,Output: i l s h t y l e a e s h a r h n w h i,220,199,21
Aria Harper William Layla Layla Elias William Olivia Luna Michael Grayson Nora David Sophia Alexander Gabriel,a r m a a s m a a l n a d a r l,16,15~22,Output: a r m a a s m a a l n d a r l,214,197,17
Emma Benjamin Zoe Jacob Sophia Isaac Victoria Violet Luke Isaac Lily Dylan Mila Asher Aurora Alexander Noah Logan William Jackson Scarlett,a n e b a c a t e c y n a r a r h n m n t,21,15~22,Output: a n e b a c a t e c y n a r a r h n m n t,223,200,23
Ethan Asher Michael Evelyn Isla Nora Willow Joseph Olivia Samuel Victoria Sebastian Aurora Aria Lucas Benjamin Lily Elizabeth,n r l n a a w h a l a n a a s n y h,18,15~22,Output: n r l n a a w h a l a n a a s n y h,218,198,20
Jacob Samuel Dylan Julian Sofia Lucas John Amelia Gabriel Ella Elizabeth Ezra James Santiago Naomi Elias Henry David Abigail Daniel,b l n n a s n a l a h a s o i s y d l l,20,15~22,Output: b l n n a s n a l a h a s o i s y d l n,220,198,22
William Aurora Ezra Scarlett Luna Miles Jackson Sebastian Riley Avery Daniel Isaac Luca Isla Mia Miles,m a a t a s n n y y l c a a a s,16,15~22,Output: m a a t a s n n y l l c a a a s,212,194,18
Lucas David Madison Matthew Grayson Hazel Aria Harper Gabriel Camila Joseph Amelia Gabriel Isaac Lucy Isabella Jacob Mila Aiden,s d n w n l a r l a h a l c y a b a n,19,15~22,Output: s d n w n l a r l a h a l c y a b a n,223,202,21
Ethan Naomi Ivy Theodore Luna Camila Isaac Zoe Gabriel Aurora Jackson Abigail Ella Isabella Miles Isla Elizabeth Mia Aiden Ella Evelyn,n i y e a a c e l a n l a a s a h a n a n,21,15~22,Output: n i y e a a c e l a n l a a s a h a n a n,226,203,23
Grayson John Camila Harper John John Noah Joseph Benjamin Ella Henry Penelope Emily Victoria Nova Gabriel,n n a r n n h h n a y e y a a l,16,15~22,Output: n n a r n n h h n a y e y a a l,214,196,18
Luke Jacob Aria Santiago Ella Julian Jack Alexander Henry Evelyn Elias David Nora Maverick William David Mateo Jacob Nora Maverick,e b a o a n k r y n s d a k m d o b a k,20,15~22,Output: e b a o a n k r y n s d a k m d o b a k,223,201,22
Joseph Emma Theodore Victoria Benjamin Aria Gianna Alexander Amelia Madison Camila Victoria Lucy Naomi Alexander Noah Victoria Victoria Luca Luke Jackson,h a e a n a a r a n a a y i r h a a a e n,21,15~22,Output: h a e a n a a r a n a a y i r h a a a e n,224,201,23
Grayson Samuel Leo Scarlett Harper Avery Mia Luke Evelyn Maverick David Elizabeth Chloe Nova Sebastian Eliana Harper Evelyn Mia Willow,n l o t r y a e n k d h e a n a r n a w,20,15~22,Output: n l o t r y a e n k d h e a n a r n a w,222,200,22
Isla Maverick Julian Matthew Samuel Elias Grayson Levi Mateo Henry Olivia Lily Samuel Abigail Eleanor Matthew Elijah John,a k n w l s n i o y a y l l r w h n,18,15~22,Output: a k n w l s n i o y a y l h r w h n,220,200,20
Madison Noah Hudson Hudson Logan Ezra Ethan Elias Mila Eleanor Julian Mila Hazel Luke Jacob Olivia Luke Scarlett Penelope Gianna Sofia,n h n n n a n s a r n a l e b a e t e a a,21,15~22,Output: n h n n n a n s a r n a l e b a e e e a,224,202,22
Mia William Elias Gabriel Hudson Mateo Gabriel Elizabeth Maverick Lily Logan Elijah Jacob Camila Emily Hazel Luke Gabriel,a m s l n o l h k y n h b a y l e l,18,15~22,Output: a m s l n o l h k y n h b a y l e l,218,198,20
Luna Thomas Logan Nova Avery Henry Elijah Madison Luke Mila Gabriel Elijah Owen Lucas Sebastian Oliver Abigail Amelia Madison Emma Jacob,a s n a y y h n e a l h n s n r l a n a b,21,15~22,Output: a s n a y y h n e a l h n s n r l a n a b,223,200,23
Hudson Abigail Harper Zoe Oliver Daniel Mila Emma Luna Oliver Gianna Thomas Miles Sebastian Thomas Logan,n l r e r l a a a r a s s n s n,16,15~22,Output: n l r e r l a a a r a s s n s n,214,196,18
Riley Sebastian Luna Olivia Mia Aria Isaac Ethan Amelia Isla Noah Scarlett Theodore Oliver Thomas,y n a a a a c n a a h t e r s,15,15~22,Output: y n a a a a c n a a h t e r s,211,194,17
Elijah Henry Abigail Isabella Maverick Elizabeth Mateo Chloe Theodore Isabella Hudson Victoria Henry Luke Olivia Thomas Gabriel Camila Ava Eliana,h y l a k h o e e a n a y e a s l a a a,20,15~22,Output: h y l a k h o e e a n y e a a s l a a a,226,204,22
Gabriel Ivy Isaac Henry Madison Violet Elizabeth Lily Luca Harper Eliana Lily Jack Avery Lucy Levi Matthew,l y c y n t h y a r a y k y y i w,17,15~22,Output: l y c y n t h y a r a y k y c i w,214,195,19
John Joseph Henry Elizabeth Thomas Asher Layla Evelyn Oliver Levi Isaac Logan Levi Mila Sofia Evelyn Camila Leo,n h y h s r a n r i c n i a a n a o,18,15~22,Output: n h y h s r a n r i c n i a a n a o,219,199,20
Victoria Emma Abigail Levi Mia Jacob Elias Emily Isabella Leo Daniel Henry Isabella Emma Julian Levi,a a l i a b s y a o l y a a n i,16,15~22,Output: a a l i a b s y a o l y a a n i,214,196,18
John Emilia William Luca Mason Emily Matthew David Eliana Liam Isabella Sofia Sofia Harper Dylan Abigail William Grace Isla,n a m a n y w d a m a a a r n l m e a,19,15~22,Output: n a m a n y w d a m a a r n l m e a,221,201,20
Mia Grayson Sophia Ella David Dylan Dylan Lucas Naomi Miles Benjamin Eleanor Aria Willow Sophia Emilia Amelia,a n a a d n n s i s n r a w a a a,17,15~22,Output: a n a a d n n s i s n r a w a a a,216,197,19
Isabella Eliana Samuel Isla Scarlett Joseph Sofia Emma Camila Penelope Lucy Henry Luna Daniel Isabella Owen,a a l a t h a a a e y y a l a n,16,15~22,Output: a a l a t h a a a e y y l a a n,217,199,18
Gabriel Asher Evelyn Charlotte Owen Theodore Aurora Henry Jack Theodore Mila Mason Owen Riley Amelia Amelia,l r n e n e a y k e a n n y a a,16,15~22,Output: l r n e n e a y k e a n n y a a,213,195,18
Ellie Elijah Lucas Jackson Riley Violet Charlotte Noah Daniel Levi Luca Elizabeth James Mia Michael Scarlett,e h s n y t e h l i a h s a l t,16,15~22,Output: e h s n y t e h l i a s e a t,210,193,17
Miles Liam Charlotte Julian Liam Elias Luke Daniel Naomi Jackson Ethan Willow Logan Luke Grayson Matthew,s m e n m s e l i n n w n e n w,16,15~22,Output: s m e n m s e l i n n w n e n w,212,194,18
Isaac Victoria Zoe Ella Riley Layla Dylan Victoria Gabriel Samuel Mia Ava Scarlett Zoe David John Ivy Noah,c a e a y a n a l l a a t e d n y h,18,15~22,Output: c a e a y a n a l l a a t e d n y h,216,196,20
Eleanor Julian Lucy Maverick Matthew Mia Joseph Sebastian Benjamin Ezra Nova Samuel Theodore Hazel William Theodore Violet Scarlett Willow Zoe Harper,r n y k w a h n n a a l e l m e t t w e r,21,15~22,Output: r n y k w a h n n a a l e l m e e t t w e e r,224,199,25
Noah Harper Layla Lily Owen Alexander Jack Olivia Willow David Zoe William James Elias Elizabeth Levi Thomas,h r a y n r k a w d e m s s h i s,17,15~22,Output: h r a y n r k a w d e m s s i s,213,195,18
Oliver Abigail Noah Nova Elias Alexander Logan Zoe Charlotte Luke Willow Nora Ellie John Thomas Julian Thomas Joseph Mateo,r l h a s r n e e e w a e n s n s h o,19,15~22,Output: r l h a s r n e e k w a e n s n s h o,219,198,21
Leo Miles Alexander Sophia Miles Miles Nova Charlotte Liam Naomi Miles Grayson Joseph Luca Levi Willow Noah Mateo David Gianna Lucas,o s r a s s a e m i s n h a i w h o d a s,21,15~22,Output: o s r a s s a e m i s n h a i w h o o d a s,225,201,24
David Avery Santiago Liam Gabriel Miles Abigail Nova Ava Penelope Hudson Mason Grace Hazel Jacob Miles Olivia,d y o m l s l a a e n n e l b s a,17,15~22,Output: d y o m l s l a a e n n e l b s a,215,196,19
Luca Evelyn Leo Miles Oliver Alexander Sophia Lucas Lily Henry Elias Luca Henry Penelope Nora Theodore Joseph Henry,a n o s r r a s y y s a y e a e h y,18,15~22,Output: a n o s r r a s y y s a y e a e h y,216,196,20
Hudson Luna Alexander Hudson Scarlett Ellie Joseph Theodore Michael Leo Elias Ezra Willow Oliver Olivia Mia Lucas Ella Isaac,n a r n t e h e l o s a w r a a s a c,19,15~22,Output: n a r n t e h e l o s a w r a a s a c,217,196,21
Lucas Noah Chloe Noah Gabriel Jack Victoria Benjamin Gabriel Ethan Leo Lily Mila Amelia Eliana Sofia John Sophia Charlotte Asher Willow,s h e h l k a n l n o y a a a a n a e r w,21,15~22,Output: s h e h l k a n l n o y a a a a a n h e r w,225,201,24
Elijah Abigail Hudson Elizabeth Willow Julian Thomas Madison Jackson Olivia Grayson Ava Hudson Olivia Miles Harper Naomi,h l n h w n s n n a n a n a s r i,17,15~22,Output: h l n h w n s n n a n a n s r r i,215,196,19
Isabella Eliana Michael Aria Harper Camila Dylan Naomi Hazel Amelia Oliver Gabriel Penelope Chloe Hudson Ethan Thomas Aria Sophia Jacob Grace,a a l a r a n i l a r l e e n n s a a b e,21,15~22,Output: a a l a r a n i l a r l e e n a a h a e,226,204,22
Jackson Mila Gabriel Oliver Alexander Madison William Benjamin Leo Oliver Isla Ivy Mason Joseph Eleanor Logan Abigail Sofia Noah Jack,n a l r r n m n o r a y n h r n l a h k,20,15~22,Output: n a l r r n m n o r a y n h r n g l h a,222,200,22
Mila Owen Oliver Elizabeth Emilia Avery David Layla Isaac Emilia Matthew Scarlett Lucy Noah Ivy Mason William Asher John Madison Mateo,a n r h a y d a c a w t y h y n m r n n o,21,15~22,Output: a n r h a y d a c a w t y h y n m r n n o,227,204,23
Isaac Isla Eleanor Noah Madison Emilia Mateo Gabriel Alexander Joseph Sebastian Avery Ivy William Jackson,c a r h n a o l r h n y y m n,15,15~22,Output: c a r h n a o l r h n y y m n,212,195,17
Layla Ethan Charlotte Theodore Willow Santiago Mia Elias Ella Daniel Elizabeth Hazel Violet Aria Ella Mason Hazel Riley Nova Camila,a n e e w o a s a l h l t a a n l y a a,20,15~22,Output: a n e e w o a s a l h l t a a n l y a a,222,200,22
Hudson Daniel Madison Aria Nora Ivy Alexander Hazel Luca Emilia Evelyn Sophia Eliana Sebastian Madison Hazel,n l n a a y r l a a n a a n n l,16,15~22,Output: n l n a a y r l a a n a a n n l,214,196,18
Layla Liam Isaac Nora Riley Emma Harper Eliana Eliana Lily Mateo Ellie Violet Emilia Emma Mila Luca Maverick Amelia,a m c a y a r a a y o e t a a a a k a,19,15~22,Output: a m c a y a r a a y o e t a a a a k a,224,203,21
Maverick Nora Thomas Mila John Samuel Levi Penelope Elizabeth Aria Abigail Isabella Ava James Luke,k a s a n l i e h a l a a s e,15,15~22,Output: k a s a n l i e h a l a a s e,215,198,17
Zoe Gabriel Grace Violet Julian Jack Ella Levi Liam Jacob Isabella Ezra Grayson Elijah Ivy Ivy Chloe Samuel Ella Elias,e l e t n k a i m b a a n h y y e l a s,20,15~22,Output: e l e t n k a i m b a a n h y y e l a s,221,199,22
Riley Charlotte Leo Ethan Lucy Aurora Asher Scarlett Willow Grayson John Santiago Mason Levi Lily Dylan Lucy Owen,y e o n y a r t w n n o n i y n y n,18,15~22,Output: y e o n y a r t w n n o n i y n y n,217,197,20
Charlotte Emily Eliana Thomas Asher Owen Theodore Henry Emily Jack Mila Liam Luke Lucy Luke Alexander Isaac Liam Asher Layla,e y a s r n e y y k a m e y e r c m r a,20,15~22,Output: e y a s r n e y y k a m e y e r c a m r a,225,202,23
Scarlett Madison Evelyn Ivy Michael Victoria Michael Jacob Emilia Owen James Owen John Dylan Leo Isaac Lucas Leo Julian Willow Ella,t n n y l a l b a n s n n n o c s o n w a,21,15~22,Output: t n n y l a l b a n s n n n o c s o n w a,222,199,23
Matthew Luke Elijah Mateo Mila Mia Penelope,w e h o a a e,7,1~8,Output: w e h o a a e,196,187,9
Sophia Eliana Luna,a a a,3,1~8,Output: a a a,186,181,5
Santiago Camila Gianna Mason,o a a n,4,1~8,Output: o a a n,189,183,6
Avery Ivy Lily Samuel Amelia Daniel Leo,y y y l a l o,7,1~8,Output: y y l l a l o,193,184,9
Eleanor Maverick Isla Zoe Evelyn Isabella Owen,r k a e n a n,7,1~8,Output: r k a e n a n,196,187,9
Olivia Emilia Hazel,a a l,3,1~8,Output: a a l,186,181,5
Lily Grayson Victoria Ella Luna David,y n a a a d,6,1~8,Output: y n a a a d,192,184,8
Eliana Amelia,a a,2,1~8,Output: a a,184,180,4
Penelope Abigail,e l,2,1~8,Output: e l,185,181,4
Elizabeth James,h s,2,1~8,Output: h s,183,179,4
Isabella Lily Liam Charlotte,a y m e,4,1~8,Output: a y m e,188,182,6
Hudson Gabriel William Elizabeth,n l m h,4,1~8,Output: n l m h,187,181,6
Noah Miles Emilia,h s a,3,1~8,Output: h s a,186,181,5
Isla Isabella Isaac Daniel,a a c l,4,1~8,Output: a a c l,189,183,6
Levi Noah Julian John,i h n n,4,1~8,Output: i h n n,187,181,6
Jackson Isabella Mason,n a n,3,1~8,Output: n a n,186,181,5
Gabriel Liam Layla,l m a,3,1~8,Output: l m a,186,181,5
Harper Ellie,r e,2,1~8,Output: r e,183,179,4
Jackson Ezra Isaac,n a c,3,1~8,Output: n a c,185,180,5
Thomas Levi,s i,2,1~8,Output: s i,183,179,4
Luke Elizabeth,e h,2,1~8,Output: e h,183,179,4
Charlotte Owen Nora,e n a,3,1~8,Output: e n a,185,180,5
Dylan Aiden Logan Daniel Harper Liam,n n n l r m,6,1~8,Output: n n n l r m,192,184,8
Harper Elijah Noah Noah Zoe Luca,r h h h e a,6,1~8,Output: r h h h e a,191,183,8
Aiden Charlotte,n e,2,1~8,Output: n e,184,180,4
Olivia Mila Eliana Lucy,a a a y,4,1~8,Output: a a a y,189,183,6
Ava Mason Thomas Aria,a n s a,4,1~8,Output: a n s a,188,182,6
Ava Nova Lily Noah Mason Mia Aiden,a a y h n a n,7,1~8,Output: a a y h n a n,194,185,9
Luca Sofia Luke Julian Sofia Leo,a a e n a o,6,1~8,Output: a a e n a o,191,183,8
Gianna Ella Aria Zoe Mason,a a a e n,5,1~8,Output: a a a e n,191,184,7
Asher Maverick,r k,2,1~8,Output: r k,185,181,4
Matthew Logan Mason Eliana,w n n a,4,1~8,Output: w n n a,188,182,6
Amelia Noah Asher,a h r,3,1~8,Output: a h r,186,181,5
Levi Ellie Gabriel,i e l,3,1~8,Output: i e l,185,180,5
Isla Thomas Nova Mason Jackson,a s a n n,5,1~8,Output: a s a n n,190,183,7
Olivia Olivia Madison Joseph Asher Emilia Lucas,a a n h r a s,7,1~8,Output: a a n h r a s,195,186,9
Aurora Eleanor Joseph,a r h,3,1~8,Output: a r h,185,180,5
Sebastian Violet,n t,2,1~8,Output: n t,183,179,4
Luca Henry Emma Sophia Aurora Ethan,a y a a a n,6,1~8,Output: a y a a a n,191,183,8
Madison Ella,n a,2,1~8,Output: n a,183,179,4
Emma Sophia Dylan Isabella Samuel Gianna Isaac,a a n a l a c,7,1~8,Output: a a n a l a c,195,186,9
Zoe Hudson Hazel,e n l,3,1~8,Output: e n l,185,180,5
Madison Penelope Isaac,n e c,3,1~8,Output: n e c,186,181,5
Evelyn Willow Theodore Matthew,n w e w,4,1~8,Output: n w e w,187,181,6
Grayson Alexander Mila,n r a,3,1~8,Output: n r a,187,182,5
Dylan James Victoria Harper Daniel,n s a r l,5,1~8,Output: n s a r l,189,182,7
Theodore Ava Lucas Luke Isla,e a s e a,5,1~8,Output: e a s e a,190,183,7
Gabriel Isla Naomi,l a i,3,1~8,Output: l a i,186,181,5
Leo Scarlett,o t,2,1~8,Output: o t,183,179,4
John Evelyn Isaac Grayson Levi,n n c n i,5,1~8,Output: n n c n i,190,183,7
Logan Chloe Zoe Michael,n e e l,4,1~8,Output: n e e l,187,181,6
Mateo Sofia,o a,2,1~8,Output: o a,184,180,4
Ella Lucas Elizabeth Hazel Benjamin Olivia,a s h l n a,6,1~8,Output: a s h l n a,191,183,8
Daniel Grace,l e,2,1~8,Output: l e,183,179,4
Julian Eliana Emily Penelope Aria Amelia Benjamin,n a y e a a n,7,1~8,Output: n a y e a a n,196,187,9
Elias Joseph Noah Nova,s h h a,4,1~8,Output: s h h a,187,181,6
Eliana Lucas,a s,2,1~8,Output: a s,184,180,4
Scarlett Harper Avery Logan Luke Henry,t r y n e y,6,1~8,Output: t r y n e y,191,183,8
Aiden Olivia Emma Luca Chloe Ezra Eliana,n a a a e a a,7,1~8,Output: n a a a e a a,195,186,9
James Emilia Lucas Aiden Noah,s a s n h,5,1~8,Output: s a s n h,191,184,7
Miles Victoria,s a,2,1~8,Output: s a,183,179,4
Joseph Isla Mateo Abigail Lucy Elizabeth,h a o l y h,6,1~8,Output: h a o l y h,194,186,8
Maverick Elias Aria Mateo Emilia,k s a o a,5,1~8,Output: k s a o a,193,186,7
Madison Jack Sofia Matthew,n k a w,4,1~8,Output: n k a w,187,181,6
Amelia Henry Mason Levi Elias Sofia,a y n i s a,6,1~8,Output: a y n i s a,191,183,8
Violet Joseph Violet Jack William Jack,t h t k m k,6,1~8,Output: t h t k m k,191,183,8
Hazel Benjamin Emily,l n y,3,1~8,Output: l n y,185,180,5
Riley William Henry Lucy John Mason,y m y y n n,6,1~8,Output: y m y y n n,191,183,8
Aria Aiden Levi Grace,a n i e,4,1~8,Output: a n i e,189,183,6
Jacob Charlotte Asher Luke Violet Madison Sophia,b e r e t n a,7,1~8,Output: b e r e t n a,194,185,9
Lucas Liam Grayson Emma Camila,s m n a a,5,1~8,Output: s m n a a,191,184,7
Grayson Levi Evelyn Emilia Luna Violet,n i n a a t,6,1~8,Output: n i n a a t,193,185,8
Penelope Asher Ava,e r a,3,1~8,Output: e r a,187,182,5
Matthew Alexander Owen Gabriel Scarlett Ivy Penelope,w r n l t y e,7,1~8,Output: w r n l t y e,194,185,9
Levi Ella Aiden,i a n,3,1~8,Output: i a n,186,181,5
Willow Madison Samuel Madison Benjamin Avery Jacob Elias Leo Hudson Penelope Olivia Leo Logan Hazel Emma Jackson Lily Gianna Leo Santiago Nora Gabriel Samuel Mateo Emilia Nova Alexander,w n l n n y b s o n e a o n l a n y a o o a l l o a a r,28,22~30,Output: w n l n n y b s o n e a o n l a a o o a l a o a o a r a l xander,242,209,33
Daniel Riley James Mateo Ezra Charlotte Chloe Mateo Henry Julian Abigail Luke Levi Dylan Isaac Sebastian Madison Samuel Nora Lucas Ezra Nora Ava Isla Maverick,l y s o a e e o y n l e i n c n n l a s a a a a k,25,22~30,Output: l y s o a e e o y n l e i n c n n l s a a a k,232,207,25
Henry Leo Ivy Jackson David Asher Penelope Mateo Alexander Mateo Alexander Mila Benjamin Joseph Henry John Miles Zoe Emma Liam Harper Elizabeth,y o y n d r e o r o r a n h y n s e a m r h,22,22~30,Output: y o y n d r e o r o r a n h y n s e a m r h,228,204,24
Layla Abigail Elijah Isaac Benjamin Ivy Ellie Mateo Maverick Lucas Zoe Violet Thomas Miles Thomas Maverick Lucy Joseph James Elijah Joseph Lily Theodore John Samuel,a l h c n y e o k s e t s s s k y h s h h y e n l,25,22~30,Output: a l h c n y e o k s e t s s k y h s h h y e n l,233,207,26
Elijah David Lily Charlotte Grayson Evelyn Asher Santiago Sofia Samuel Henry David Miles Joseph Layla Matthew Penelope Lucy Naomi Julian Avery Olivia Owen Gianna Liam Jacob Matthew,h d y e n n r o a l y d s h a w e y i n y a n a m b w,27,22~30,Output: h d y e n n r o a l y d s h a w e y i h n a y a a a n m,239,209,30
Gianna Miles Gianna Isla Luna Benjamin Isaac Elizabeth Leo William Elizabeth Ezra Emilia Owen Michael Lucas Aria Madison Maverick Henry Liam Mason Luca Lucas Matthew Amelia Owen Elizabeth,a s a a a n c h o m h a a n l s a n k y m n a s w a n h,28,22~30,Output: a s a a a n c h o m h a a a n n y m n a s w a a w a a h a n h,244,211,33
Sophia Elizabeth Scarlett Harper Sofia Isaac Amelia Luna Olivia Matthew Charlotte Chloe Theodore Ellie Grace Aurora Madison Amelia Alexander Elijah Camila Elias Oliver Layla Mila Camila,a h t r a c a a a w e e e e e a n a r h a s r a a a,26,22~30,Output: a h t r a c a a a w e e e e e a n a r h a s r a a,234,207,27
Eliana Aurora Elijah Abigail Jacob Grayson Thomas Maverick Ezra Mateo Dylan Layla Elijah Aurora Isla Michael Owen Levi Lucas Scarlett Olivia Nora Harper Isla Ivy Abigail Thomas,a a h l b n s k a o n a h a a l n i s t a a r a y l s,27,22~30,Output: a a h l b n s k a o n a h a a l n i s t a a r a y l s,242,213,29
Amelia Abigail Layla Hudson Daniel Avery Santiago Julian Ava Elias Daniel Aiden Eliana Grace Ellie Ethan William Mason Lucy Matthew Mason Harper Lucy Lucas Sophia,a l a n l y o n a s l n a e e n m n y w n r y s a,25,22~30,Output: a l a n l y o n a s l n a e e n m n y w n r y s a,233,206,27
Leo Ethan Mia Aria Isla Ezra Abigail Layla Jackson James Thomas William David Mason Chloe Mason Samuel Joseph Asher Mateo Riley William Ava Matthew Julian Emily Harper,o n a a a a l a n s s m d n e n l h r o y m a w n y r,27,22~30,Output: o n a a a a l a n s s m d n e n l h r o y m a w n y n y r,241,210,31
Olivia Avery David Michael Aria Riley Violet Mason Ava Miles Emilia Hazel Charlotte Luca Abigail Riley Camila Maverick Evelyn Matthew Ivy Benjamin Asher,a y d l a y t n a s a l e a l y a k n w y n r,23,22~30,Output: a y d l a y t n a s a l e t a y a k n w h y n r,232,206,26
Mateo Hudson Michael Ellie Asher Jackson Dylan Asher Penelope Luna Gabriel Noah Violet Layla Violet Harper Ivy Emma Theodore Thomas Isabella Jacob Samuel Thomas Emily Isla Layla,o n l e r n n r e a l h t a t r y a e s a b l s y a a,27,22~30,Output: o n l e r n n r e a l h t a a r r y a e s s a b l s a s y a a,245,212,33
Isla Abigail Emily Hazel Julian Ava Liam Aria Jack Hudson Elias Santiago Isaac Jacob Ellie Victoria Samuel Harper Naomi Willow Lucy Logan Emma,a l y l n a m a k n s o c b e a l r i w y n a,23,22~30,Output: a l y l n a m a k n s o c b e a l r i w w y n a,229,203,26
Grace Hazel Jacob Julian Avery Camila Sophia Levi Hazel Owen Oliver Mason Emily Isla Ivy Elias Mila Elias Alexander Ava Mia Gabriel Alexander William Ethan Daniel Abigail Dylan Aria,e l b n y a a i l n r n y a y s a s r a a l r m n l l n a,29,22~30,Output: e l b n y a a i l n r n y a y s a s r a a l r a m n l r m a,243,211,32
Mateo Oliver Logan David Luke Ethan Jack Michael Ellie Mila Layla Mia Asher Daniel Alexander Asher Lucas John Hudson Owen Elijah Santiago Charlotte Victoria,o r n d e n k l e a a a r l r r s n n n h o e a,24,22~30,Output: o r n d e n k l e a a a r l r r s n n h n h o e o,233,206,27
Henry Eleanor Olivia Hudson Aiden Naomi Lucy Ellie Zoe John Benjamin Hudson Owen Sebastian Willow Isla Nova Harper Amelia Leo Penelope Grayson Grace William Willow Mason Hazel Logan Sofia,y r a n n i y e e n n n n n w a a r a o e n e m w n l n a,29,22~30,Output: y r a n n i y e e n n n n w a a r a o e n e n e m l a,239,210,29
Jackson Penelope Isla Amelia Alexander Michael Scarlett Elijah Aurora James Luke Emilia Levi Ezra Ezra Santiago Henry Emilia Joseph Avery Luca Dylan,n e a a r l t h a s e a i a a o y a h y a n,22,22~30,Output: n e a a r l t h a s e a i a a o y a h a,225,203,22
Dylan Scarlett Ellie Hazel Isaac Harper Mason Santiago Olivia Ava Emilia Theodore Grace Hudson Camila Aurora Sofia Grace Mila Dylan Alexander Violet Sebastian Elijah Eleanor Mateo Thomas Alexander,n t e l c r n o a a a e e n a a a e a n r t n h r o s r,28,22~30,Output: n t e l c r n o a a a e e n a a a e a a n r o s r,236,209,27
Mateo Elizabeth Willow William Elias Mason Hazel Evelyn Eleanor Aiden Lucy Sebastian Luke Alexander Samuel Emma Emily Ivy Abigail Mason Olivia Ava Julian,o h w m s n l n r n y n e r l a y y l n a a n,23,22~30,Output: o h w m s n l n r n y n e r l a y y v l n a a n,229,203,26
Elias Sophia Gabriel Zoe Sofia Thomas Noah Mia Jackson Owen Hudson Joseph Matthew Madison Dylan Ezra Owen Levi Jacob Camila Aurora Ivy Sebastian Evelyn Isaac Ezra Dylan,s a l e a s h a n n n h w n n a n i b a a y n n c a n,27,22~30,Output: s a l e a s h a n n n h w n n a n i b a a c n a a,232,205,27
Sophia Noah Santiago Asher Matthew Naomi Grayson Lucy Zoe Emilia Henry Luke Asher Willow Liam John Riley Dylan Aiden Victoria Gabriel Isla Harper Ella,a h o r w i n y e a y e r w m n y n n a l a r a,24,22~30,Output: a h o r w i n y e a y e r w m n y n n a l a r a,233,207,26
Isla Jack Luca Oliver John Grayson Matthew Matthew Elizabeth Naomi Thomas Jack Ella Harper Oliver Asher David Eleanor Ellie Maverick Abigail Mila Sebastian Nova Thomas Madison Grayson,a k a r n n w w h i s k a r r r d r e k l a n a s n n,27,22~30,Output: a k a r n n w w h i s k a r r r d r e k l a n a s n a n,241,211,30
Elias Aria Willow Madison Isaac Amelia Miles Santiago Luca Camila Ezra Ella Isaac Logan William Benjamin Ethan Michael Ethan Dylan Jack Dylan Violet Penelope Charlotte Emily,s a w n c a s o a a a a c n m n n l n n k n t e e y,26,22~30,Output: s a w n c a s o a a a a c n m n n l n l n e e e y,233,206,27
Lily Henry Aurora Grayson Mila Luca Sebastian Julian Naomi Maverick Penelope Leo Benjamin Alexander Luca Avery Miles Ivy Ava Isla Dylan Hudson,y y a n a a n n i k e o n r a y s y a a n n,22,22~30,Output: y y a n a a n n i k e o n r a y s a a a a n n,229,204,25
Joseph Julian Lucas Aiden Elizabeth Oliver Miles Charlotte Willow Hazel Mason Lucas Oliver Luca Alexander Avery Alexander Lucas Santiago Elizabeth Mateo Asher Julian,h n s n h r s e w l n s r a r y r s o h o r n,23,22~30,Output: h n s n h r s e w l n s r a r y r s o h o,226,203,23
Samuel Benjamin Aria Dylan Penelope Logan Julian Isla Avery Emilia Isla Abigail Emma Sebastian Penelope Scarlett Theodore Ezra Grayson Olivia Michael Eliana Aurora,l n a n e n n a y a a l a n e t e a n a l a a,23,22~30,Output: l n a n e n n a y a a l a n e e t e n a l a a,234,209,25
Logan Isla Charlotte Mason Layla Isla Elizabeth Maverick Elijah Alexander Owen Hazel Mateo Aurora Grace Leo Eliana Thomas Hudson Samuel Aria Ethan Luke Violet Lily Michael Oliver Aria,n a e n a a h k h r n l o a e o a s n l a n e t y l r a,28,22~30,Output: n a e n a a h k h r n l o a e o a s n l a n e t l y l r a,244,213,31
Sophia Riley Thomas Victoria Sofia Hudson Eleanor Hazel John Chloe Liam Layla Violet Logan Dylan Oliver Madison Benjamin Gabriel Elias Henry Jacob Jack Henry Eleanor Amelia Ava Maverick Jackson,a y s a a n r l n e m a t n n r n n l s y b k y r a a k n,29,22~30,Output: a y s a a n r l n e m a t n n r n y r a a a k n,234,208,26
Aurora Jacob James Asher Ava Madison Mateo Mila Aria Nova Dylan Jacob Willow Layla Asher Aurora Leo Elijah Joseph Chloe Noah Dylan Zoe Olivia Ella Michael Levi Eliana Oliver,a b s r a n o a a a n b w a r a o h h e h n e a a l i a r,29,22~30,Output: a b s r a n o a a a n b w a r a o h h e a h n e a a l,242,213,29
Isla Riley Elizabeth David Elizabeth Ezra Aurora Nova Luca William Ivy Willow Aurora Madison Joseph Julian Eleanor Madison Penelope Maverick Joseph Ethan Leo Ethan Benjamin David Charlotte Asher Thomas,a y h d h a a a a m y w a n h n r n e k h n o n n d e r s,29,22~30,Output: a y h d h a a a a m y w a n h n r n e k h n o o n n d e r s,242,210,32
Ivy Oliver Sophia Levi Jackson Jacob Julian Nora Joseph Aria Sophia Nora Madison Liam Elias Lily Abigail Alexander Emma Harper Isaac Luca Gabriel Daniel James Sophia Logan Henry,y r a i n b n a h a a a n m s y l r a r c a l l s a n y,28,22~30,Output: y r a i n b n a h a a a n m s s y l l r a r c a l n l,236,207,29
Aurora Olivia Violet Elias Julian Lily Elizabeth Luca Mia Alexander Theodore Gianna Sebastian Jacob Jack Charlotte Isabella Victoria Leo Matthew Willow Nova Layla Aurora Camila Elias Leo Samuel Julian,a a t s n y h a a r e a n b k e a a o w w a a a a s o l n,29,22~30,Output: a a t s n y h a a r e a n b k e a a o o w a a a s o l n,240,210,30
Elijah Amelia James Mason Zoe Noah Ethan Isaac Samuel Willow Asher Aria Liam Noah Ivy Jack Mila Camila Jack Miles Victoria Ezra Madison Julian,h a s n e h n c l w r a m h y k a a k s a a n n,24,22~30,Output: h a s n e h n c l w r a m h y k a a k s a z n n,231,205,26
Ava Lucy Gianna Oliver Camila Mateo Henry Eliana Ivy Sophia Elizabeth Isabella Grace Mia Joseph Noah Mia Lucy Grayson Henry Layla Violet Elias Samuel Naomi,a y a r a o y a y a h a e a h h a y n y a t s l i,25,22~30,Output: a y a r a o y a y a h a e a h h a y a a s l t s l i,237,209,28
Mateo William Henry Willow Dylan Mila Matthew Isabella Luca Layla Benjamin Chloe Hazel Mia Santiago Aiden Ellie Ella Charlotte Ellie Amelia Samuel Theodore Henry,o m y w n a w a a a n e l a o n e a e e a l e y,24,22~30,Output: o m y w n a w a a a n e l a o o n e a e e a l e y,233,206,27
Elias Hudson David Noah Miles Lucas Mila Amelia Mia Scarlett Penelope Emma James Elijah Ezra Daniel Camila Layla Lucy Miles Joseph Julian Alexander,s n d h s s a a a t e a s h a l a a y s h n r,23,22~30,Output: s n d h s s a a a t e a s h a l a a y s h n r,229,204,25
Ellie Abigail Victoria Ella Jackson Evelyn Ava Abigail Penelope Julian Gabriel Riley Leo Maverick Ethan Theodore Emma Luca Zoe Ethan Emma Nora Harper Evelyn Henry Gianna Mila Chloe Levi,e l a a n n a l e n l y o k n e a a e n a a r n y a a e i,29,22~30,Output: e l a a n n a l e n l y o k n n a a e e n a r n y a a e i,243,212,31
Elizabeth Ellie Julian Mia Mason Daniel Leo Grace Joseph Jack Luca Nova Grace Emilia Hudson Theodore William Ella Mateo Penelope Isabella Camila Nora Isaac,h e n a n l o e h k a a e a n e m a o e a a a c,24,22~30,Output: h e n a n l o e h k a a e a n e m a o e a a a c,232,206,26
Luna Victoria William Noah Nora Asher Layla Samuel Nova Aurora Riley Sophia Emily Levi Violet Nora Nora Penelope David Olivia Scarlett Victoria,a a m h a r a l a a y a y i t a a e d a t a,22,22~30,Output: a a m h a r a l a a y a y i t a a e d a t a,226,202,24
Isabella Riley Jackson Owen Harper Asher Joseph Gabriel Willow Miles Henry Lily Lucas Zoe Isabella Gianna Eleanor James Benjamin Aiden Lucy Elizabeth Maverick Hudson Riley Zoe Elijah Luca Emma,a y n n r r h l w s y y s e a a r s n n y h k n y e h a a,29,22~30,Output: a y n n r r h l w s y y s e a a a r s n n y e h n y e h a u a,245,212,33
Isabella Samuel Luca Ezra Owen Olivia Luca Violet Thomas Ella Dylan Alexander Leo Aiden Avery Hudson Theodore Mia Ellie Isaac Madison Daniel Oliver Eliana Maverick,a l a a n a a t s a n r o n y n e a e c n l r a k,25,22~30,Output: a l a a n a a t s a n r o n y n e a e c n l a k,232,206,26
Samuel Gabriel Isaac Aria Asher Aria Hudson Levi Eleanor Logan Luke Thomas Scarlett Miles Emilia Eliana Alexander Gabriel Camila Isaac Chloe Samuel Michael Lucas,l l c a r a n i r n e s t s a a r l a c e l l s,24,22~30,Output: l l c a r a n i r n e s t s s a a r l a c l e l s,234,207,27
Aria Charlotte Matthew Julian Willow Jack Evelyn Benjamin Daniel Michael Aiden Chloe Ava Luke Naomi Ella Ivy Violet Mateo Olivia Ethan John Isaac David Jacob Jacob Liam Penelope Isaac,a e w n w k n n l l n e a e i a y t o a n n c d b b m e c,29,22~30,Output: a e w n w k n n l l n e e k i a a y t o a n n c d b b m e c,242,210,32
Emma Jack Dylan Isla Asher John Luca Camila Elijah Madison Nova Violet Gianna Levi Madison Logan Michael Leo Willow Ava Luna Sofia Ellie Logan Gabriel Mila,a k n a r n a a h n a t a i n n l o w a a a e n l a,26,22~30,Output: a k n a r n a a h n a t a i n n l l w a a a a e n l a,237,208,29
Riley Penelope Santiago Daniel Benjamin Aiden Aurora John Emily Grace Zoe Penelope Theodore Leo Jacob Theodore Asher Elias Ava Santiago Santiago Gabriel Nova Lily Miles Oliver Jackson Camila,y e o l n n a n y e e e e o b e r s a o o l a y s r n a,28,22~30,Output: y e o l n n a n y e e e e o b r s a o o l a y s r n a,239,210,29
Luke Matthew Mason Ezra Eliana Isla Grayson Matthew Gianna Isaac Ella Ellie Hudson John Mia Asher Chloe Ava Dylan Evelyn Ella Levi Isla Julian Jack Madison Abigail Luke Noah,e w n a a a n w a c a e n n a r e a n n a i a n k n l e h,29,22~30,Output: e w n a a a n w a c a e n n a r e a n n a i e h n l h,242,213,29
Mia Isaac Elizabeth Samuel Logan Penelope Aria Julian Scarlett Samuel Luca Victoria Levi Violet Elijah Benjamin Olivia Mia Santiago Noah Eleanor Gabriel Sebastian Amelia Mason,a c h l n e a n t l a a i t h n a a o h r l n a n,25,22~30,Output: a c h l n e a n t l a a i t h n a a o h r l n a n,231,204,27
Lucas Joseph Chloe Mason Isaac Riley Isaac Naomi Julian John Penelope Lucas Jacob Grayson Thomas Ethan Avery Nora Violet Benjamin Theodore Sofia Matthew Miles Jacob Jack Leo Charlotte,s h e n c y c i n n e s b n s n y a t n e a w s b k o e,28,22~30,Output: s h e n c y c i n n e s b n s n y a t n w s b e a t w s,237,207,30
Elijah Gianna Sophia Luke Emilia Grayson Noah Hazel Hazel Avery Eliana Charlotte Aria Jackson Aria Isla Evelyn Scarlett Elias Camila Mason Gabriel Aiden Hudson Luke Jack Elias Maverick,h a a e a n h l l y a e a n a a n t s a n l n n e k s k,28,22~30,Output: h a a e a n h l y a e e a n a a n t s a n l n n e k,243,215,28
Hazel Lucas Isabella Ella Isaac Elijah Victoria Elizabeth Olivia Penelope Jacob Elizabeth Joseph Hazel Aiden Emily Riley Willow Levi Miles Madison Emma Elias Eliana Violet Elijah Nova,l s a a c h a h a e b h h l n y y w i s n a s a t h a,27,22~30,Output: l s a a c h a h a e b h h l n y y w i s n a s a a t h a,238,208,30
Luke Emily Maverick Michael David Samuel Aurora Evelyn Aria Lucy Thomas Isla Willow William Willow Aria Michael Ava Samuel Aiden Benjamin Lucy Michael Abigail Lucas Levi Ella Levi Avery,e y k l d l a n a y s a w m w a l a l n n y l l s i a i y,29,22~30,Output: e y k l d l a n a y s a w m w a l a l n n y l l a i y,241,212,29
Asher Elijah Alexander Naomi Violet Gabriel Daniel Violet Nova Santiago Ivy Olivia Riley Noah Samuel Leo William Amelia Dylan David Violet Aurora David Luca Elijah Abigail,r h r i t l l t a o y a y h l o m a n d t a d a h l,26,22~30,Output: r h r i t l l t a o y a y h l o m a n d t a d a h l,233,205,28
Luca Emilia Amelia Ella Avery Sofia Jack Ella Jackson Ella Owen Mila Santiago Liam Nova Ellie Nova Emily Owen Grace Oliver Ezra,a a a a y a k a n a n a o m a e a y n e r a,22,22~30,Output: a a a a y a k a n a n a o a m a e a y n e,224,201,23
Amelia Zoe Gabriel Luke Victoria Ella Daniel Maverick Chloe Luke Jacob Jacob Scarlett Willow Leo Santiago Levi Sebastian Hudson Sebastian Julian Asher Mila Emilia James John,a e l e a a l k e e b b t w o o i n n n n r a a s n,26,22~30,Output: a e l e a a l k e e b b t w o o i n n n n r a a s n,235,207,28
Aurora Scarlett Daniel Luna Amelia Emily Maverick Jackson Hazel Sebastian Hazel Daniel Madison Gianna Avery Isaac Penelope Luke Gianna Violet Riley Elias Avery,a t l a a y k n l n l l n a y c e e a t y s y,23,22~30,Output: a t l a a y k n l n l l n a y c e e a t y s y,229,204,25
Samuel Riley Sebastian Evelyn Owen Leo Samuel Jacob Luke Isla Asher Charlotte Ella Mila Aria Aiden Joseph Ivy Liam Mia Violet Amelia Zoe Evelyn Ella John Hudson Sofia,l y n n n o l b e a r e a a a n h y m a t a e n a n n a,28,22~30,Output: l y n n w n l b e a r e a a n h y m a t a e n a n n d n a,241,210,31
Samuel Sophia Lily Layla Mateo Mateo Leo Nora Mason James Michael Mila Grace Lily Violet Abigail Layla Grayson Noah Theodore Lucy Jacob Asher Harper,l a y a o o o a n s l a e y t l a n h e y b r r,24,22~30,Output: l a y a o o o a n s l a e y t l a n h r e y b r,235,209,26
James Oliver Emilia Emilia Luna Leo Abigail Isla Madison Ellie Isaac Elizabeth William Grayson Camila Zoe Nova Ella Alexander Lucas Dylan Penelope Ezra Gabriel Elizabeth Isaac Ezra Layla,s r a a a o l a n e c h m n a e a a r s n e a l h c a a,28,22~30,Output: s r a a a o l a n e c h m n a e a r s a n e a l,239,213,26
Ellie Evelyn Michael Chloe Grace Santiago Lucy Olivia Ella Lucy Ezra Luca Aria Matthew Elijah Aiden Liam Miles Matthew Lucy Grayson Scarlett Levi Lucy Nova Thomas Elijah,e n l e e o y a a y a a a w h n m s w y n t i y a s h,27,22~30,Output: e n l e e o y a a y a a a w h n m s w y n t t s i y a s s h,239,207,32
Ellie Maverick Aurora Emilia Elizabeth Oliver Luca Benjamin Joseph Benjamin Mateo Harper Michael Miles Levi Mateo Matthew Aiden Charlotte Ellie Gianna William Leo Willow Henry Luca Mason Mason Aria,e k a a h r a n h n o r l s i o w n e e a m o w y a n n a,29,22~30,Output: e k a a h r a n h n o r l s i o w n e a m o w y a n n a,243,213,30
Sophia Mateo Willow Charlotte David Sebastian Matthew Ellie James Isla Isabella Ethan Mia Benjamin Sofia Emily Sofia Emily Aurora Scarlett Sophia Alexander Amelia Nora,a o w e d n w e s a a n a n a y a y a t a r a a,24,22~30,Output: a o w e d n w e s a a n a n a a y a a t a r a,229,204,25
Mila Sebastian John Harper Ellie Santiago Samuel Liam Luca Theodore Scarlett Camila Ethan Victoria Mason Dylan Isabella Madison Sebastian Elijah Emma Gianna Elias William Charlotte Samuel Jack Alexander Oliver,a n n r e o l m a e t a n a n n a n n h a a s m e l k r r,29,22~30,Output: a n n r e o l m a e t a n a n n a h a a m a a s l e l k r,241,210,31
Aria Evelyn Riley Zoe Maverick Santiago Henry Nova Eliana Henry Ava Victoria Daniel Lucas Eleanor Emilia Scarlett Henry Emily Eleanor Michael Ellie,a n y e k o y a a y a a l s r a t y y r l e,22,22~30,Output: a n y e k o y a a y a a l s r y y r l e,225,203,22
Grayson Aria Abigail Michael Avery Charlotte Jack Naomi Santiago Luke Elias Hudson Logan Ava James Benjamin Jack Miles Zoe Aiden Sebastian Madison Chloe Mateo Jacob Isabella Aria Luke,n a l l y e k i o e s n n a s n k s e n n n e o b a a e,28,22~30,Output: n a l l y e k i o e s n n a s n k s e n n e o b a a e,241,212,29
Ezra Michael Sebastian Camila Camila Asher Luke Samuel Isla Lucy Daniel Ava Gianna Dylan James Lucy Hudson Ava Emma Leo Isaac Mia Logan Mila Sofia,a l n a a r e l a y l a a n s y n a a o c a n a a,25,22~30,Output: a l n a a r e l a y l a a n s y n a a o c a n a a,235,208,27
Asher Samuel Elias Theodore Violet Ava Mateo Isla Daniel Asher Logan Matthew Jackson Daniel Mila Aria Samuel Sebastian Harper Samuel Charlotte Daniel Sebastian,r l s e t a o a l r n w n l a a l n r l e l n,23,22~30,Output: r l s e t a o a l r n w h l a a l n r l e n,230,206,24
David Emily William Avery Aria Mia Benjamin Violet Mason Eliana Emma Ezra Mila Harper Julian Aurora Hazel Hazel Eleanor Daniel Asher Matthew,d y m y a a n t n a a a a r n a l l r l r w,22,22~30,Output: d y m y a a n t n a a a a r n a l l r l r w,227,203,24
Ivy Henry Sebastian Jackson Daniel Nova Aria Jackson Aria Ezra Gabriel Oliver Mateo Gabriel Elizabeth Willow Luna Ivy Scarlett Sophia Owen Matthew Aiden Isaac,y y n n l a a n a a l r o l h w a y t a n w n c,24,22~30,Output: y y n n l a a n a a l r o o l h w a y t a n w,230,205,25
James Gianna Sebastian Hudson Theodore Liam Charlotte Luna Victoria Emilia Aurora Gianna Theodore Gabriel Joseph Scarlett Avery Charlotte Mateo Leo Riley Noah Eleanor Sophia,s a n n e m e a a a a a e l h t y e o o y h r a,24,22~30,Output: s a n n e m e a a a a e l h t e o o y h r a,229,205,24
Mila Ava David Gabriel Evelyn Lucas Dylan Henry Lily Hudson Owen Henry Benjamin Victoria Isla Mia Madison Isabella Ezra Santiago Emma Oliver Charlotte Penelope Leo Victoria,a a d l n s n y y n n y n a a a n a a o a r e e o a,26,22~30,Output: a a d l n s n y y n n y n a a a n a z o a r e o a,234,207,27
Aria Willow Luca Henry Abigail Isaac Theodore Samuel Evelyn David Daniel Mateo Naomi Aurora Maverick Isaac Mila Zoe Isla Grayson Violet Michael,a w a y l c e l n d l o i a k c a e a n t l,22,22~30,Output: a w a y l c e l n d l o i a k c a e a n t l,230,206,24
Charlotte Charlotte Maverick Matthew Madison James Isaac Aria Lily Riley Ava Aiden Violet Isla Charlotte Charlotte Olivia Chloe Jackson Maverick Isla Levi Emilia,e e k w n s c a y y a n t a e e a e n k a i a,23,22~30,Output: e e k w n s c a y y a n t a e e a e n k a i a,232,207,25
Luna Ella Lucas Isla Noah Benjamin Ava Noah Isabella Eliana Elijah Sophia Asher James Ellie Scarlett Isaac Miles Noah Mason Amelia Logan Hudson Henry Charlotte Zoe Noah Jackson,a a s a h n a h a a h a r s e t c s h n a n n y e e h n,28,22~30,Output: a a s a h n a h a a h a r s e t c s h n a n n y e e h n,239,209,30
Layla Isaac Elias Isaac Willow Evelyn Amelia Victoria Emma Alexander Oliver Miles Mila Grayson Grace Liam Hudson Luke Scarlett Emma Ellie Zoe,a c s c w n a a a r r s a n e m n e t a e e,22,22~30,Output: a c s c w n a a a r r s a n e m n e t a e e e,227,202,25
Grace Madison Jacob Levi Joseph David Luca Henry Ella Mateo Hazel Aiden Ethan Gianna Penelope Ella Daniel Ella Liam John Chloe Riley Camila Hazel Jacob Harper,e n b i h d a y a o l n n a e a l a m n e y a l b r,26,22~30,Output: e n b i h d a y a o l n n a e a l a m n e y a l b r,236,208,28
Scarlett Hazel Aiden Grace Benjamin Ivy Noah Hudson Avery Willow Penelope,t l n e n y h n y w e,11,8~15,Output: t l n e n y h n y w e,203,190,13
Ava Michael Zoe Ethan Ivy Luca Luca Isla Miles Ava Oliver,a l e n y a a a s a r,11,8~15,Output: a l e n y a a a s a r,202,189,13
Lucy Ivy Mason Mia Aurora Gianna Sofia Luke Isla Jackson Miles,y y n a a a a e a n s,11,8~15,Output: y y n a a a a e a n s,203,190,13
Riley Benjamin Mia Liam Lily Santiago James Riley Lucy Henry Emma Layla,y n a m y o s y y y a a,12,8~15,Output: y n a m y o s y c y a a,204,190,14
Mia Aria Daniel Sebastian Luna Oliver Luna Zoe Mila Ellie Asher Eliana Sofia,a a l n a r a e a e r a a,13,8~15,Output: a a l n a r a e a e r a a,209,194,15
Evelyn Lucas Scarlett Chloe Willow Aria Naomi Sofia,n s t e w a i a,8,8~15,Output: n s t e w a i a,196,186,10
Oliver Elias Madison Lily Oliver Logan Ezra Eliana Elizabeth Scarlett Hazel,r s n y r n a a h t l,11,8~15,Output: r s n y r n a a h t l,202,189,13
Luna Thomas Luke Thomas Luke Emma Benjamin Victoria Harper Julian Charlotte Aiden Chloe,a s e s e a n a r n e n e,13,8~15,Output: a s e s e a n a r n e n e,206,191,15
Gianna Mateo Alexander Riley Grayson Avery Hazel Luca Harper Mila Penelope Grace,a o r y n y l a r a e e,12,8~15,Output: a o r y n y l a r a e e,208,194,14
Maverick Victoria Ezra Emma Daniel Alexander Luke Emma Lily Nova Luca Mason Alexander,k a a a l r e a y a a n r,13,8~15,Output: k a a a l r e a y a a n r,206,191,15
Charlotte Nova Leo James Elizabeth Jack Willow Mateo,e a o s h k w o,8,8~15,Output: e a o s h k w o,196,186,10
Matthew Madison Isabella James Isaac David James Evelyn Nova Levi Willow,w n a s c d s n a i w,11,8~15,Output: w n a s c d s n a i w,202,189,13
Charlotte Camila Samuel Jack Oliver Avery Eliana Noah Henry Isabella Lily Logan,e a l k r y a h y a y n,12,8~15,Output: e a l k r y a h y a y n,206,192,14
Sofia Nova Mia Henry Ivy Lucy Dylan Emma Elizabeth Elias Dylan Lucas,a a a y y y n a h s n s,12,8~15,Output: a a a y y c n a h s n s,203,189,14
Zoe Jack Elijah Mila Naomi Nova Aiden Hazel Leo Madison,e k h a i a n l o n,10,8~15,Output: e k h a i a n l o n,201,189,12
Mateo Samuel Isla Mateo Eleanor Ava Benjamin Lucas Miles Avery,o l a o r a n s s y,10,8~15,Output: o l a o r a n s s y,202,190,12
Elizabeth Benjamin Ivy Elizabeth Emma William Miles Mia,h n y h a m s a,8,8~15,Output: h n y h a m s a,195,185,10
Ava Nova Eleanor Noah Sebastian Charlotte Lucas Isabella Elizabeth Alexander Ethan Gianna,a a r h n e s a h r n a,12,8~15,Output: a a r h n e s a h r n a,205,191,14
Theodore Santiago Theodore Mason Grace Elijah Grayson Layla Gabriel Victoria John Santiago Sophia,e o e n e h n a l a n o a,13,8~15,Output: e o e n e h n a l a n o a,207,192,15
Camila Mason Mia Isaac Michael John Ellie Isabella Asher Asher Nova,a n a c l n e a r r a,11,8~15,Output: a n a c l n e a r r a,205,192,13
Ethan Daniel Zoe Naomi Aiden Grayson Julian Olivia Henry Sofia Evelyn Ezra,n l e i n n n a y a n a,12,8~15,Output: n l e i n n n a y a n a,205,191,14
Luke Aiden Elijah Alexander Charlotte Nora Ella Emma Dylan Mateo,e n h r e a a a n o,10,8~15,Output: e n h r e a a a n o,201,189,12
Asher Michael Miles Penelope Sebastian Charlotte Mia Hazel Layla Lucas Mila,r l s e n e a l a s a,11,8~15,Output: r l s e n e a l a s a,205,192,13
Luca Ezra James John Evelyn Sebastian Victoria Eleanor,a a s n n n a r,8,8~15,Output: a a s n n n a r,195,185,10
Nova Willow Scarlett Logan Emilia Aria Nora Mila Naomi Elias Gabriel Emily Julian,a w t n a a a a i s l y n,13,8~15,Output: a w t n a a a a i s l y n,208,193,15
Levi Abigail Mason Amelia Logan Hazel Violet Ella Ella James Matthew,i l n a n l t a a s w,11,8~15,Output: i l n a n l t a a s w,202,189,13
Isabella Theodore Ezra Asher Oliver Levi Mila Alexander Ezra,a e a r r i a r a,9,8~15,Output: a e a r r i a r a,200,189,11
Liam Mia Sofia Layla Luca Nova Penelope Aurora,m a a a a a e a,8,8~15,Output: m a a a a a e a,197,187,10
John Asher Samuel Thomas Luca Victoria Luke Mateo Luna,n r l s a a e o a,9,8~15,Output: n r l s a a e o a,199,188,11
Sebastian Luca Sebastian Emilia Amelia Aiden Nora Gabriel James Elias James,n a n a a n a l s s s,11,8~15,Output: n a n a a n a l s s s,203,190,13
Theodore Gabriel Grace Zoe Penelope Matthew Layla Owen Aurora Dylan Elias,e l e e e w a n a n s,11,8~15,Output: e l e e e w a n a n s,203,190,13
Penelope Mia John Zoe Nora Luke Ivy Joseph Maverick Luna Camila Sophia,e a n e a e y h k a a a,12,8~15,Output: e a n e a e y h k a a a,206,192,14
Mila Naomi Abigail Mia Charlotte Daniel Julian Olivia Aurora Benjamin Elizabeth,a i l a e l n a a n h,11,8~15,Output: a i l a e l n a a n h,203,190,13
Olivia Sebastian Sebastian Madison Aurora Luna Riley Mia Emily,a n n n a a y a y,9,8~15,Output: a n n n a a y a y,197,186,11
Violet Matthew Charlotte Eleanor Mia Aiden Mila Mia Luca Violet Elizabeth,t w e r a n a a a t h,11,8~15,Output: t w e r a n a a a t h,203,190,13
Ellie Lily Matthew Isabella Joseph Camila Gabriel William Lucy Sofia Mila Julian Avery,e y w a h a l m y a a n y,13,8~15,Output: e y w a h a l m y a a n y,208,193,15
Emilia Harper Sebastian Victoria Ava Emma Elizabeth Mia Penelope Logan Mateo,a r n a a a h a e n o,11,8~15,Output: a r n a a a h a e o,203,191,12
Evelyn Levi Scarlett David Luke Liam Leo Theodore Isla Mia Emma Riley Owen Layla,n i t d e m o e a a a y n a,14,8~15,Output: n i t d e m o e a a a y n a,209,193,16
Gianna Olivia James Miles Samuel Joseph Amelia Emilia Oliver Luna Julian,a a s s l h a a r a n,11,8~15,Output: a a s s l h a a r a n,203,190,13
John Joseph Aurora Scarlett Victoria Michael Thomas Jacob Gabriel Emma Grace,n h a t a l s b l a e,11,8~15,Output: n h a t a l s b l a e,201,188,13
Joseph Abigail Owen Emily Gianna Alexander Alexander Ethan Maverick Michael Ethan Miles Nora,h l n y a r r n k l n s a,13,8~15,Output: h l n y a r r n k l n s a,208,193,15
Hudson Evelyn Mateo Henry Alexander Aurora William Charlotte,n n o y r a m e,8,8~15,Output: n n o y r a m e,196,186,10
Jack Chloe Isla Mason Naomi Isaac Maverick Hudson Isabella Grace Ellie James Dylan,k e a n i c k n a e e s n,13,8~15,Output: k e a n i c k n a e e s n,208,193,15
Jack Luca Alexander Lucas Nova Zoe Eleanor Luca Maverick Abigail Ella Isabella Jackson Chloe,k a r s a e r a k l a a n e,14,8~15,Output: k a r s a e r a k l a a n e,210,194,16
Asher Thomas Mason Jack Evelyn Logan Miles James Samuel,r s n k n n s s l,9,8~15,Output: r s n k n n s s l,198,187,11
Michael Lucy Isaac Nora Ezra Santiago Benjamin Dylan William Sebastian,l y c a a o n n m n,10,8~15,Output: l y c a a o n n m n,199,187,12
Gianna Joseph Mia Mila Harper Nora Elizabeth Eleanor Ellie Riley Victoria Henry Zoe Amelia,a h a a r a h r e y a y e a,14,8~15,Output: a h a a r a h r e y a y e a,209,193,16
Isabella Elizabeth Mateo Aurora Nova Joseph Emily Hudson Luna Scarlett Lucas,a h o a a h y n a t s,11,8~15,Output: a h o a a h y n a t s,203,190,13
Liam Daniel Elijah Aiden Mason David Mateo Emily,m l h n n d o y,8,8~15,Output: m l h n n d o y,197,187,10
Dylan Charlotte Aria Alexander Victoria David Owen Henry Avery Luna Aria Samuel,n e a r a d n y y a a l,12,8~15,Output: n e a r a d n y y a a l,205,191,14
Isla Noah Chloe Levi Penelope Eleanor Henry Avery Mia Elijah Olivia,a h e i e r y y a h a,11,8~15,Output: a h e i e r y y a h a,203,190,13
Ellie Logan Benjamin Isabella Jack Sebastian Nora Maverick Camila Ethan Owen,e n n a k n a k a n n,11,8~15,Output: e n n a k n a k a n n,204,191,13
Emily Harper Nora Ava Violet Logan Luna Henry Elias,y r a a t n a y s,9,8~15,Output: y r a a t n a y s,197,186,11
Oliver Lucas Isabella Sofia Amelia James Benjamin Isabella Lucy Avery Naomi Elizabeth,r s a a a s n a y y i h,12,8~15,Output: r s a a a s n a y y i h,205,191,14
Hudson Emilia Mateo Eliana Riley Isaac Aurora Violet Luke Daniel Hazel Gabriel,n a o a y c a t e l l l,12,8~15,Output: n a o a y c a t e l l l,206,192,14
Aiden Avery Mason Eliana Penelope Jackson Lucy Ava Amelia,n y n a e n y a a,9,8~15,Output: n y n a e n y a a,200,189,11
Olivia Elizabeth Nova Ivy Luca James Mason Olivia Mia Liam Noah Eleanor Lily Ezra,a h a y a s n a a m h r y a,14,8~15,Output: a h a y a s n a a m h r y a,207,191,16
Charlotte Maverick Ezra Grace Jackson Julian Asher Dylan Jackson Evelyn Mia,e k a e n n r n n n a,11,8~15,Output: e k a e n n r n n a,202,190,12
Luca John Sophia Lily Eliana Elijah Maverick Eleanor Jack Willow,a n a y a h k r k w,10,8~15,Output: a n a y a h k r k w,201,189,12
Madison Victoria Alexander Hudson Isla Chloe Penelope Ava Joseph,n a r n a e e a h,9,8~15,Output: n a r n a e e a h,199,188,11
Aiden Scarlett Jack Madison Levi Violet Aurora Elias Mason Ezra,n t k n i t a s n a,10,8~15,Output: n t k n i t a s n a,200,188,12
William Isabella Oliver Dylan Isla Mia Zoe Scarlett Jackson Willow James Theodore Logan,m a r n a a e t n w s e n,13,8~15,Output: m a r n a a e t n w s e n,207,192,15
Emily Ella Santiago Layla Michael Logan Oliver Sebastian Daniel Olivia Gianna Elizabeth Emma,y a o a l n r n l a a h a,13,8~15,Output: y a o a l n r n l a a h a,207,192,15
Liam Grayson Isabella Noah Ava Ellie Eliana Aurora Joseph Mila Victoria Lucas Ella,m n a h a e a a h a a s a,13,8~15,Output: m n a h a e a a h a a s a,209,194,15
Isla Ethan Olivia Ava Logan Michael Owen Jacob Liam Emily Dylan,a n a a n l n b m y n,11,8~15,Output: a n a a n l n b m y n,202,189,13
Isabella Jacob Penelope Jackson Thomas Elizabeth Aiden Theodore Elijah Sophia Hazel Henry,a b e n s h n e h a l y,12,8~15,Output: a b e n s h n e h a l y,206,192,14
Thomas Jacob Nova Matthew Chloe Zoe Mason Logan Luca Sophia Luke,s b a w e e n n a a e,11,8~15,Output: s b a w e e n n a a e,201,188,13
Eliana Aiden Benjamin Julian Luna Sebastian Michael Victoria,a n n n a n l a,8,8~15,Output: a n n n a n l a,197,187,10
Abigail Aurora Chloe Mila David Willow Mason Dylan Avery Luca,l a e a d w n n y a,10,8~15,Output: l a e a d w n n y a,201,189,12
Elijah Harper Luke Miles Isabella Emma Ethan Eleanor,h r e s a a n r,8,8~15,Output: h r e s a a n r,196,186,10
Aurora Sophia Zoe James Charlotte Mia James Scarlett Elias Noah Luna,a a e s e a s t s h a,11,8~15,Output: a a e s e a s t s h a,201,188,13
Henry Joseph Isla Eliana Sofia Hazel Miles Benjamin Samuel Gabriel Emma Gabriel Lucy Gabriel,y h a a a l s n l l a l y l,14,8~15,Output: y h a a a l s n l l a l y,208,193,15
Dylan Amelia Gianna Samuel Ava Madison Eleanor Sofia Elijah Benjamin,n a a l a n r a h n,10,8~15,Output: n a a l a n r a h n,200,188,12
Ellie Jack Charlotte Willow Nora Luca Julian Julian Aiden Olivia,e k e w a a n n n a,10,8~15,Output: e k e w a a n n n a,200,188,12
Sebastian Maverick Elizabeth David Violet Olivia Mila Penelope Olivia Santiago Lily Liam Charlotte,n k h d t a a e a o y m e,13,8~15,Output: n k h d t a a e a o y m e,208,193,15
