input,out,len,bins,pred,total-tokens,prompt-tokens,completion-tokens
Paula Fernando Alejandro Alvaro Isabel Antonio Angel Carmen Alvaro Antonia Jorge Carmen Fernando Josefa Jose Alberto Javier Antonio Lucia,a o o o l o l n o a e n o a e o r o a,19,15~22,Output: a o o o l o l n o a e n o a e o a,193,174,19
Francisco Miguel Sergio Jesus Javier Alberto Carmen Javier Fernando Manuel Alejandro Jose Fernando Josefa Angel Lucia Jose Sergio Jose,o l o s r o n r o l o e o a l a e o e,19,15~22,Output: o l o s r o n r o l o e e a l a e o e,190,169,21
Maria Angel Fernando Josefa Fernando Alberto Francisco Fernando Miguel Dolores Jose Carlos Manuel Isabel Carlos Manuel Alberto,a l o a o o o o l s e s l l s l o,17,15~22,Output: a l o a o o o o l s e s l l s o,186,168,18
Alejandro Alvaro Isabel Isabel Lucia Alvaro Dolores Juan Josefa Jose Alvaro Miguel Javier Josefa Josefa Angel Lucia Alvaro,o o l l a o s n a e o l r a a l a o,18,15~22,Output: o o l l a o s n a e l r a a l a o,198,179,19
Alvaro Manuel Manuel Manuel Carmen Jesus Josefa Jose Carlos Pablo Francisco Jose Javier Manuel Javier Antonio Javier Carmen Antonia Marta,o l l l n s a e s o o e r l r o r n a a,20,15~22,Output: o l l l n s a e s o o e r l r o r n a a,196,174,22
Jorge Manuel Javier Miguel Miguel Lucia Fernando Alvaro Manuel Pablo Miguel Dolores Alvaro Miguel Jorge,e l r l l a o o l o l s o l e,15,15~22,Output: e l r l l a o o l o l o o e,185,169,16
Jorge Fernando Antonia Josefa Miguel Jesus Alejandro Jesus Alvaro Juan Carlos Isabel Fernando Alberto Antonio Antonio Javier Carlos,e o a a l s o s o n s l o o o o r s,18,15~22,Output: e o a a l s o s o n s l o o o o r s,191,171,20
Dolores Jesus Alvaro Lucia Miguel Francisco Javier Fernando Alvaro Marta Marta Pablo Javier Alvaro Carmen Sergio Alvaro,s s o a l o r o o a a o r o n o o,17,15~22,Output: s s o a l o r o o a a o r o n o o,196,177,19
Fernando Pablo Carlos Jorge Pablo Juan Lucia Josefa Carmen Lucia Dolores Fernando Jose Fernando Pablo Antonia Marta Alejandro,o o s e o n a a n a s o e o o a a o,18,15~22,Output: o o s e o n a a n a s o e o o a a o,191,171,20
Manuel Jose Jose Isabel Jorge Pablo Manuel Lucia Jesus Jorge Carmen Maria Jose Isabel Carlos Miguel Miguel Alvaro,l e e l e o l a s e n a e l s l l o,18,15~22,Output: l e e l e o l a s e n a e l s l o,188,169,19
Josefa Jose Jose Alejandro Lucia Sergio Jose Jose Dolores Antonia Jesus Sergio Miguel Fernando Francisco Maria Isabel Francisco Antonio Paula Juan,a e e o a o e e s a s o l o o a l o o a n,21,15~22,Output: a e e o a o e e s a s o l o o a a l o o a n,197,173,24
Josefa Sergio Miguel Alvaro Jorge Jose Alejandro Miguel Jose Juan Miguel Jesus Carlos Pablo Maria Jesus Antonio Angel Alvaro Alejandro,a o l o e e o l e n l s s o a s o l o o,20,15~22,Output: a o l o e e o l e s s o a a s o l o o,195,174,21
Alejandro Carlos Manuel Alberto Carmen Dolores Carlos Alvaro Paula Alejandro Dolores Fernando Alejandro Jorge Juan Fernando,o s l o n s s o a o s o o e n o,16,15~22,Output: o s l o s s s o a o s o o e n o,187,169,18
Angel Juan Miguel Jose Francisco Manuel Jose Antonio Manuel Miguel Jesus Marta Dolores Jesus Fernando Miguel,l n l e o l e o l l s a s s o l,16,15~22,Output: l n l e o l e o l l s a s s o l,185,167,18
Jose Jose Jesus Antonio Carmen Josefa Jesus Francisco Juan Alvaro Jesus Javier Marta Jose Pablo Marta,e e s o n a s o n o s r a e o a,16,15~22,Output: e e s o n a s o n o s r a e o a,188,170,18
Alberto Josefa Fernando Paula Alvaro Maria Manuel Javier Carmen Carmen Maria Carmen Angel Javier Juan Carmen Francisco Jose,o a o a o a l r n n a n l r n n o e,18,15~22,Output: o a o a o a l r n n a n l r n n o e,190,170,20
Jose Jesus Maria Carlos Javier Pablo Isabel Jose Dolores Sergio Miguel Miguel Carlos Jose Jose Fernando Jose Josefa,e s a s r o l e s o l l s e e o e a,18,15~22,Output: e s a s r o l e s o l l s e e o e a,189,169,20
Marta Alvaro Dolores Isabel Jorge Carmen Josefa Alejandro Miguel Isabel Manuel Fernando Miguel Jesus Lucia Antonia Juan Paula,a o s l e n a o l l l o l s a a n a,18,15~22,Output: a o s l e n a o l l l o l s a a n a,193,173,20
Jose Javier Jose Alberto Fernando Juan Alejandro Jose Alvaro Angel Antonia Isabel Juan Carlos Carlos Antonio Manuel Alvaro Antonia Alejandro,e r e o o n o e o l a l n s s o l o a o,20,15~22,Output: e r e o o n o e o l a l n s s o l o a o,197,175,22
Juan Marta Manuel Angel Dolores Dolores Angel Carmen Alejandro Javier Isabel Lucia Antonio Pablo Miguel Isabel Juan Alvaro Jose Sergio,n a l l s s l n o r l a o o l l n o e o,20,15~22,Output: n a l l s s l n o r l a o o l l n o e o,196,174,22
Carmen Marta Antonio Jorge Francisco Jose Dolores Dolores Alberto Dolores Jose Jesus Francisco Josefa Dolores,n a o e o e s s o s e s o a s,15,15~22,Output: n a o e o e s s o s e s o a s,187,170,17
Alvaro Alejandro Paula Fernando Javier Jorge Jose Juan Alvaro Alejandro Maria Dolores Alejandro Fernando Antonia Carmen Francisco Maria Fernando,o o a o r e e n o o a s o o a n o a o,19,15~22,Output: o o a o r e e n o o a s o o a n o a a o,196,174,22
Fernando Isabel Jorge Fernando Jorge Antonia Fernando Fernando Juan Jose Antonia Josefa Alejandro Angel Paula Angel Miguel Jose Angel Alberto Maria,o l e o e a o o n e a a o l a l l e l o a,21,15~22,Output: o l e o e a o o n e a a o l a l l e l o a,196,173,23
Alberto Jose Antonia Jose Carmen Josefa Dolores Jesus Isabel Antonia Juan Miguel Lucia Alberto Sergio Jorge,o e a e n a s s l a n l a o o e,16,15~22,Output: o e a e n a s s l a n l a o o e,187,169,18
Paula Jorge Maria Miguel Jesus Javier Jorge Josefa Josefa Fernando Lucia Isabel Carmen Angel Dolores Marta Sergio Fernando Jose Fernando,a e a l s r e a a o a l n l s a o o e o,20,15~22,Output: a e a l s r e a a o a l n l s a o o e o,195,173,22
Fernando Paula Lucia Carmen Alejandro Marta Angel Jose Alberto Angel Carlos Angel Josefa Francisco Angel Jose,o a a n o a l e o l s l a o l e,16,15~22,Output: o a a n o a l e o l s l a o e,184,167,17
Pablo Fernando Miguel Manuel Miguel Alberto Javier Javier Antonio Jorge Carmen Manuel Alberto Marta Carmen Alejandro Alvaro,o o l l l o r r o e n l o a n o o,17,15~22,Output: o o l l l o r r o e n l o a n o o,188,169,19
Paula Sergio Manuel Juan Miguel Jesus Paula Jesus Jesus Angel Miguel Paula Miguel Alejandro Carmen Carlos Antonia Jose Lucia Marta,a o l n l s a s s l l a l o n s a e a a,20,15~22,Output: a o l n l s a s s l l a l o n s a e a,192,171,21
Jorge Manuel Maria Francisco Isabel Alejandro Jose Jose Paula Alvaro Maria Carlos Alejandro Alejandro Jose Pablo,e l a o l o e e a o a s o o e o,16,15~22,Output: e l a o l o e e a o a s o o e o,185,167,18
Fernando Juan Maria Jose Marta Carmen Carmen Javier Francisco Alvaro Manuel Paula Alejandro Miguel Antonia Alvaro,o n a e a n n r o o l a o l a o,16,15~22,Output: o n a e a n n r o o l a o l a o,189,171,18
Manuel Jesus Alberto Sergio Marta Josefa Francisco Antonio Antonio Dolores Angel Marta Jorge Jorge Jesus Carlos Carmen Jorge Paula Miguel,l s o o a a o o o s l a e e s s n e a l,20,15~22,Output: l s o o a a o o o s l a e e s s n e a l,195,173,22
Antonio Maria Josefa Dolores Carmen Miguel Alejandro Isabel Alvaro Javier Fernando Pablo Alvaro Carlos Jesus Jesus Manuel Fernando Josefa Carmen,o a a s n l o l o r o o o s s s l o a n,20,15~22,Output: o a a s n l o l o r o o s s l o a n,196,176,20
Carmen Carmen Jose Jorge Antonio Maria Maria Francisco Javier Angel Juan Josefa Carlos Lucia Jesus Javier Sergio Antonia,n n e e o a a o r l n a s a s r o a,18,15~22,Output: n n e e o a a o r l n a s a s r o a,189,169,20
Isabel Jesus Carlos Francisco Fernando Carlos Carmen Francisco Paula Francisco Miguel Jose Jesus Carmen Carmen Dolores Manuel Francisco,l s s o o s n o a o l e s n n s l o,18,15~22,Output: l s s o o s n o a o l e s s n n s l o,189,168,21
Sergio Jorge Josefa Paula Maria Angel Carmen Jesus Maria Paula Isabel Lucia Antonio Jesus Jesus Maria Fernando,o e a a a l n s a a l a o s s a o,17,15~22,Output: o e a a a l n s a a l a o s s a o,186,167,19
Antonia Dolores Paula Carlos Jesus Angel Dolores Jose Antonia Sergio Jose Sergio Alejandro Paula Francisco Jose Isabel Miguel Fernando Javier,a s a s s l s e a o e o o a o e l l o r,20,15~22,Output: a s a s s l s e a o e o e a o o e l l o r,196,173,23
Paula Jose Francisco Manuel Manuel Manuel Fernando Carlos Marta Carlos Francisco Paula Angel Alejandro Carlos Lucia,a e o l l l o s a s o a l o s a,16,15~22,Output: a e o l l l o s a s o a l o s a,184,166,18
Sergio Juan Jose Josefa Marta Angel Miguel Josefa Jose Jesus Fernando Lucia Alejandro Jose Jesus Manuel Paula Angel Manuel Isabel,o n e a a l l a e s o a o e s l a l l l,20,15~22,Output: o n e a a l l a e s o a o e s l a l l l,194,172,22
Jose Pablo Miguel Carmen Francisco Sergio Alvaro Antonio Dolores Jose Francisco Alvaro Marta Angel Lucia Antonio Alberto Jesus,e o l n o o o o s e o o a l a o o s,18,15~22,Output: e o l n o o o o s e o o a l a o o s,193,173,20
Jesus Antonia Jorge Josefa Sergio Manuel Manuel Francisco Isabel Juan Javier Miguel Lucia Javier Juan Jose Francisco Pablo,s a e a o l l o l n r l a r n e o o,18,15~22,Output: s a e a o l l o l n r l a r n e o o,189,169,20
Angel Isabel Angel Antonio Alberto Antonia Jose Fernando Marta Jose Jorge Alvaro Manuel Miguel Alejandro Sergio,l l l o o a e o a e e o l l o o,16,15~22,Output: l l l o o a e o a e e o l l o o,187,169,18
Antonio Fernando Fernando Jorge Manuel Alejandro Alvaro Francisco Carmen Antonia Pablo Isabel Jesus Jesus Juan Angel Fernando Carmen Antonia Maria,o o o e l o o o n a o l s s n l o n a a,20,15~22,Output: o o o e l o o o n a o l s s n l o n a a,195,173,22
Alejandro Fernando Carlos Jorge Antonia Lucia Dolores Carlos Pablo Alberto Carmen Carlos Isabel Javier Francisco Paula Carlos Juan,o o s e a a s s o o n s l r o a s n,18,15~22,Output: o o s e a a s s o o n s l r o a s n,189,169,20
Francisco Javier Angel Jose Manuel Javier Lucia Paula Isabel Fernando Marta Josefa Isabel Dolores Francisco Alvaro,o r l e l r a a l o a a l s o o,16,15~22,Output: o r l e l r a a l o a a l s o,187,170,17
Paula Paula Isabel Sergio Marta Paula Jose Alvaro Juan Carlos Miguel Sergio Alvaro Lucia Lucia Maria Carlos Javier Miguel Antonio Pablo,a a l o a a e o n s l o o a a a s r l o o,21,15~22,Output: a a l o a a e o n s l o o a a a s r l o o l,199,175,24
Pablo Sergio Antonio Antonia Jorge Antonia Sergio Paula Antonia Alberto Lucia Carmen Antonia Fernando Marta,o o o a e a o a a o a n a o a,15,15~22,Output: o o o a e a o a a o a n a o a,186,169,17
Isabel Manuel Jose Francisco Jose Paula Alejandro Juan Alejandro Pablo Javier Fernando Jorge Jorge Sergio Paula,l l e o e a o n o o r o e e o a,16,15~22,Output: l l e o e a o n o o r o e e o a,183,165,18
Jose Carmen Dolores Alberto Jesus Alberto Jorge Fernando Lucia Dolores Pablo Dolores Carlos Alvaro Francisco Isabel Carlos Paula Miguel,e n s o s o e o a s o s s o o l s a l,19,15~22,Output: e n s o s o e o a s o s s o o l s a l,194,173,21
Maria Javier Alejandro Jose Isabel Sergio Sergio Jose Jesus Jorge Paula Manuel Maria Jose Francisco Miguel Jose Maria,a r o e l o o e s e a l a e o l e a,18,15~22,Output: a r o e l o o e s e a l a e o l e a,187,167,20
Javier Alejandro Antonia Miguel Angel Jose Javier Jose Carmen Alberto Paula Juan Pablo Antonio Lucia Carmen Javier Antonia Marta Alejandro Angel,r o a l l e r e n o a n o o a n r a a o l,21,15~22,Output: r o a l l e r e n o a n o o a n r a a o l,196,173,23
Carmen Jesus Paula Miguel Lucia Jesus Lucia Sergio Alejandro Carlos Javier Alvaro Alvaro Carlos Carlos Josefa Carmen Pablo Javier Jesus,n s a l a s a o o s r o o s s a n o r s,20,15~22,Output: n s a l a s a o o s r o o s s a n o r s,196,174,22
Paula Angel Pablo Josefa Jesus Carmen Antonio Maria Paula Alvaro Josefa Francisco Maria Paula Jesus Francisco Antonio Alberto Dolores Juan,a l o a s n o a a o a o a a s o o o s n,20,15~22,Output: a l o a s n o a a o a o a a s o o s n,195,174,21
Carlos Alvaro Antonio Miguel Marta Juan Alvaro Manuel Jose Javier Jesus Carlos Jose Maria Carlos,s o o l a n o l e r s s e a s,15,15~22,Output: s o o l a n o l e r s s e a s,186,169,17
Javier Alejandro Manuel Isabel Paula Sergio Manuel Jose Alvaro Francisco Maria Jesus Juan Antonia Javier Jesus Alejandro Paula Alejandro Manuel,r o l l a o l e o o a s n a r s o a o l,20,15~22,Output: r o l l a o l e o o a s n a r s o a o l,194,172,22
Sergio Lucia Sergio Jorge Pablo Francisco Alejandro Manuel Isabel Jesus Isabel Carlos Alejandro Alberto Carlos,o a o e o o o l l s l s o o s,15,15~22,Output: o a o e o o o l l s l s o o s,181,164,17
Jorge Carmen Dolores Alvaro Marta Alberto Antonio Manuel Juan Carlos Javier Antonia Manuel Carmen Paula Angel Carmen Angel Jesus,e n s o a o o l n s r a l n a l n l s,19,15~22,Output: e n s o a o o l n s r a l n a l n l s,194,173,21
Marta Josefa Sergio Angel Pablo Carmen Alejandro Alberto Marta Lucia Carlos Paula Maria Jose Miguel Jose,a a o l o n o o a a s a a e l e,16,15~22,Output: a a o l o n o o a a s a a e l e,186,168,18
Jose Javier Alvaro Antonia Antonio Miguel Alvaro Jose Sergio Pablo Alvaro Pablo Alvaro Dolores Antonia Jose Antonia Isabel,e r o a o l o e o o o o o s a e a l,18,15~22,Output: e r o a o l o e o o o o s a e a l,198,179,19
Miguel Paula Isabel Manuel Fernando Juan Fernando Juan Paula Alejandro Alejandro Jesus Javier Francisco Alvaro Francisco Alberto Manuel,l a l l o n o n a o o s r o o o o l,18,15~22,Output: l a l l o n o n a o o s r o o o o l,189,169,20
Antonia Antonia Miguel Josefa Dolores Lucia Carmen Javier Sergio Carmen Antonia Antonio Juan Sergio Jose Isabel Carlos,a a l a s a n r o n a o n o e l s,17,15~22,Output: a a l a s a n r o n a o n o e l s,190,171,19
Josefa Angel Francisco Javier Juan Alberto Juan Paula Paula Miguel Jose Jorge Josefa Alberto Marta,a l o r n o n a a l e e a o a,15,15~22,Output: a l o r n o n a a l e e a o a,184,167,17
Jose Antonia Isabel Paula Josefa Jose Paula Alvaro Carmen Pablo Jesus Jorge Paula Jesus Angel Javier Antonio Lucia Carmen Josefa Sergio,e a l a a e a o n o s e a s l r o a n a o,21,15~22,Output: e a l a a e a o n o s e a s l r o a n a o,198,175,23
Juan Javier Carlos Alvaro Jose Jorge Jose Josefa Angel Paula Lucia Sergio Antonio Pablo Juan,n r s o e e e a l a a o o o n,15,15~22,Output: n r s o e e e a l a a o o o n,184,167,17
Pablo Pablo Jose Juan Javier Angel Jose Miguel Fernando Juan Marta Jose Antonia Alejandro Alejandro Antonio Josefa Javier Angel Manuel,o o e n r l e l o n a e a o o o a r l l,20,15~22,Output: o o e n r l e l o n a e a o o o a r l l,194,172,22
Javier Antonia Dolores Isabel Fernando Juan Carmen Pablo Antonia Miguel Dolores Jesus Lucia Miguel Javier Marta,r a s l o n n o a l s s a l r a,16,15~22,Output: r a s l o n n o a l s s a l r a,188,170,18
Javier Francisco Maria Jesus Jose Antonio Jesus Jose Fernando Alejandro Carmen Sergio Miguel Isabel Sergio Javier Francisco Antonia Pablo Jesus,r o a s e o s e o o n o l l o r o a o s,20,15~22,Output: r o a s e o s e o o o n o l o r o a o s,192,170,22
Manuel Antonia Juan Francisco Juan Juan Dolores Carlos Alberto Dolores Jose Alberto Antonio Francisco Marta Juan Alvaro Fernando Josefa Antonio,l a n o n n s s o s e o o o a n o o a o,20,15~22,Output: l a n o n n s s o s e o o o a n o o a o,198,176,22
Paula Carlos Francisco Antonia Maria Sergio Alvaro Marta Alberto Jesus Juan Maria Javier Jorge Javier Jose Carlos Carlos,a s o a a o o a o s n a r e r e s s,18,15~22,Output: a s o a a o o a o s n a r e r e s s,191,171,20
Juan Francisco Josefa Marta Antonio Juan Jorge Jose Isabel Francisco Marta Alejandro Antonia Sergio Jose Javier,n o a a o n e e l o a o a o e r,16,15~22,Output: n o a a o n e e l o a o a o e r,187,169,18
Jose Dolores Lucia Josefa Angel Jose Alvaro Juan Jesus Josefa Josefa Lucia Maria Dolores Juan Isabel,e s a a l e o n s a a a a s n l,16,15~22,Output: e s a a l e o n s a a a a s n l,190,172,18
Manuel Miguel Fernando Fernando Fernando Miguel Francisco Dolores Alberto Sergio Isabel Antonia Jose Manuel Javier Antonia Carlos Manuel Miguel,l l o o o l o s o o l a e l r a s l l,19,15~22,Output: l l o o o l o s o o l a e l r a s l l,192,171,21
Carmen Pablo Paula Francisco Marta Maria Isabel Angel Angel Lucia Lucia Miguel Antonio Juan Manuel Jorge Antonia Alejandro Lucia Lucia,n o a o a a l l l a a l o n l e a o a a,20,15~22,Output: n o a o a a l l l a a l o n l l e a o a a a,195,171,24
Dolores Manuel Carlos Alberto Alberto Angel Pablo Manuel Francisco Fernando Fernando Fernando Antonia Marta Carmen Fernando,s l s o o l o l o o o o a a n o,16,15~22,Output: s l s o o l o l o o o o a a n o,186,168,18
Angel Alberto Isabel Carmen Fernando Jose Alvaro Angel Antonia Pablo Alvaro Sergio Angel Antonio Javier Fernando Alberto,l o l n o e o l a o o o l o r o o,17,15~22,Output: l o l n o e o l a o o o l o r o o,190,171,19
Javier Isabel Jose Paula Paula Paula Marta Maria Angel Jorge Angel Sergio Josefa Marta Angel Isabel Fernando Carmen,r l e a a a a a l e l o a a l l o n,18,15~22,Output: r l e a a a a a l e l o a a l l o n,190,170,20
Isabel Jose Paula Alberto Jesus Marta Josefa,l e a o s a a,7,1~8,Output: l e a o s a a,167,158,9
Alvaro Marta Isabel,o a l,3,1~8,Output: o a l,160,155,5
Javier Josefa Jesus Jorge Sergio Pablo Angel,r a s e o o l,7,1~8,Output: r a s e o o l,166,157,9
Jesus Jorge Lucia Josefa Angel Pablo Isabel,s e a a l o l,7,1~8,Output: s e a a l o l,166,157,9
Alvaro Sergio Jose Marta Angel,o o e a l,5,1~8,Output: o o e a l,164,157,7
Francisco Dolores,o s,2,1~8,Output: o s,156,152,4
Alvaro Antonia Carmen Jose Carmen Carlos,o a n e n s,6,1~8,Output: o a n e n s,166,158,8
Juan Josefa Francisco Lucia Alberto,n a o a o,5,1~8,Output: n a o a o,162,155,7
Josefa Marta Carlos Pablo Dolores,a a s o s,5,1~8,Output: a a s o s,164,157,7
Alejandro Marta Alejandro Marta Sergio Antonia,o a o a o a,6,1~8,Output: o a o a o a,166,158,8
Pablo Alberto Sergio Sergio Alvaro Paula,o o o o o a,6,1~8,Output: o o o o o a,165,157,8
Alejandro Angel Antonio Fernando Isabel,o l o o l,5,1~8,Output: o l o o l,161,154,7
Fernando Alberto Jose Sergio Lucia Alejandro Pablo,o o e o a o o,7,1~8,Output: o o e o a o o,165,156,9
Angel Juan Manuel,l n l,3,1~8,Output: l n l,157,152,5
Jesus Sergio Jose,s o e,3,1~8,Output: s o e,157,152,5
Alberto Jorge Alvaro Pablo Jorge Josefa Miguel,o e o o e a l,7,1~8,Output: o e o o e a l,168,159,9
Jose Sergio Lucia,e o a,3,1~8,Output: e o a,157,152,5
Antonia Sergio Fernando,a o o,3,1~8,Output: a o o,158,153,5
Carlos Jose Lucia Manuel Alvaro,s e a l o,5,1~8,Output: s e a l o,163,156,7
Antonio Isabel Alberto,o l o,3,1~8,Output: o l o,157,152,5
Antonia Jesus Paula Miguel Josefa Jorge Angel,a s a l a e l,7,1~8,Output: a s a l a e l,167,158,9
Alvaro Juan Lucia Jesus Alvaro Alejandro Jose,o n a s o o e,7,1~8,Output: o n a s o o e,169,160,9
Carlos Marta Francisco Alvaro Antonia Josefa Carlos,s a o o a a s,7,1~8,Output: s a o o a a s,170,161,9
Isabel Jorge Jose Isabel Fernando Juan,l e e l o n,6,1~8,Output: l e e l o n,163,155,8
Carmen Manuel Jorge,n l e,3,1~8,Output: n l e,157,152,5
Isabel Alberto Paula,l o a,3,1~8,Output: l o a,157,152,5
Carlos Jose,s e,2,1~8,Output: s e,155,151,4
Carmen Francisco Fernando,n o o,3,1~8,Output: n o o,157,152,5
Dolores Lucia Fernando Javier Dolores Carlos,s a o r s s,6,1~8,Output: s a o r s s,165,157,8
Lucia Maria,a a,2,1~8,Output: a a,155,151,4
Jorge Isabel Paula Antonia Jesus Jorge Jose,e l a a s e e,7,1~8,Output: e l a a s e e,166,157,9
Antonio Isabel Josefa Maria,o l a a,4,1~8,Output: o l a a,160,154,6
Sergio Josefa Pablo,o a o,3,1~8,Output: o a o,158,153,5
Antonio Alberto Alejandro Javier Carmen Pablo,o o o r n o,6,1~8,Output: o o o r n o,163,155,8
Jesus Jesus Josefa Jorge Antonio Jesus Carmen,s s a e o s n,7,1~8,Output: s s a e o s n,166,157,9
Manuel Carmen Josefa Fernando Jorge,l n a o e,5,1~8,Output: l n a o e,162,155,7
Angel Jorge Miguel Javier,l e l r,4,1~8,Output: l e l r,159,153,6
Carmen Lucia Carmen,n a n,3,1~8,Output: n a n,157,152,5
Alvaro Josefa Lucia Francisco Maria Maria,o a a o a a,6,1~8,Output: o a a o a a,166,158,8
Juan Alejandro Jose Antonio Antonia Pablo Carmen,n o e o a o n,7,1~8,Output: n o e o a o n,166,157,9
Jorge Dolores Javier Alberto,e s r o,4,1~8,Output: e s r o,160,154,6
Isabel Javier Javier Carlos Carlos Alvaro,l r r s s o,6,1~8,Output: l r r s s o,165,157,8
Carmen Miguel Antonio,n l o,3,1~8,Output: n l o,157,152,5
Juan Angel Angel Javier Jose Manuel,n l l r e l,6,1~8,Output: n l l r e l,163,155,8
Sergio Antonio Manuel Carmen Maria Antonio,o o l n a o,6,1~8,Output: o o l n a o,163,155,8
Jesus Fernando Jorge,s o e,3,1~8,Output: s o e,157,152,5
Maria Dolores Sergio,a s o,3,1~8,Output: a s o,158,153,5
Antonio Juan,o n,2,1~8,Output: o n,155,151,4
Jesus Pablo Jose Javier Maria Jesus,s o e r a s,6,1~8,Output: s o e r a s,163,155,8
Lucia Francisco Antonio Antonia Paula,a o o a a,5,1~8,Output: a o o a a,162,155,7
Angel Pablo Carmen,l o n,3,1~8,Output: l o n,157,152,5
Lucia Jose Jose Jose Angel,a e e e l,5,1~8,Output: a e e e l,161,154,7
Carlos Carlos Paula,s s a,3,1~8,Output: s s a,157,152,5
Alberto Isabel Juan Antonio,o l n o,4,1~8,Output: o l n o,159,153,6
Manuel Antonio,l o,2,1~8,Output: l o,155,151,4
Manuel Miguel Manuel Jorge Francisco,l l l e o,5,1~8,Output: l l l e o,161,154,7
Jose Paula Miguel Francisco,e a l o,4,1~8,Output: e a l o,159,153,6
Sergio Paula Marta Paula Carmen Juan Carmen,o a a a n n n,7,1~8,Output: o a a a n n n,166,157,9
Javier Jose Carlos Antonia Jorge Dolores Antonio,r e s a e s o,7,1~8,Output: r e s a e s o,167,158,9
Lucia Antonia Lucia Jorge Antonia Carmen,a a a e a n,6,1~8,Output: a a a e a n,165,157,8
Marta Carlos Alberto Josefa,a s o a,4,1~8,Output: a s o a,161,155,6
Carlos Miguel Miguel Miguel Alvaro,s l l l o,5,1~8,Output: s l l l o,163,156,7
Josefa Carmen Paula Antonio Francisco Alvaro,a n a o o o,6,1~8,Output: a n a o o o,166,158,8
Alberto Javier Dolores Carmen Fernando,o r s n o,5,1~8,Output: o r s n o,162,155,7
Antonio Jose Javier Pablo Isabel,o e r o l,5,1~8,Output: o e r o l,161,154,7
Alejandro Josefa Miguel Josefa Carlos,o a l a s,5,1~8,Output: o a l a s,163,156,7
Jesus Fernando Marta Sergio Carlos Jesus Lucia,s o a o s s a,7,1~8,Output: s o a o s s a,166,157,9
Marta Jesus Juan,a s n,3,1~8,Output: a s n,158,153,5
Paula Maria Josefa Josefa Maria Juan Alberto,a a a a a n o,7,1~8,Output: a a a a a n o,167,158,9
Antonio Maria Carmen Isabel Manuel,o a n l l,5,1~8,Output: o a n l l,161,154,7
Pablo Jorge Paula Alberto Jesus,o e a o s,5,1~8,Output: o e a o s,161,154,7
Isabel Miguel Maria Francisco,l l a o,4,1~8,Output: l l a o,159,153,6
Miguel Jose Sergio Alvaro Alejandro,l e o o o,5,1~8,Output: l e o o o,163,156,7
Carlos Manuel Antonio Carmen,s l o n,4,1~8,Output: s l o n,159,153,6
Isabel Miguel Isabel Fernando Pablo,l l l o o,5,1~8,Output: l l l o o,161,154,7
Alejandro Carmen Sergio Marta Juan Angel Manuel Juan Marta Isabel Juan Maria Alvaro Alberto Francisco Alberto Pablo Dolores Antonio Fernando Alberto Alberto Dolores Antonio Jorge Jorge,o n o a n l l n a l n a o o o o o s o o o o s o e e,26,22~30,Output: o n o a n l l n a l n a o o o o o s o o o e e,206,181,25
Antonio Juan Angel Josefa Sergio Paula Miguel Angel Sergio Juan Maria Jose Carlos Dolores Isabel Jorge Javier Juan Lucia Javier Paula Jesus Dolores,o n l a o a l l o n a e s s l e r n a r a s s,23,22~30,Output: o n l a o a l l o n a e s s l e r n a r a s s,200,175,25
Lucia Juan Isabel Carmen Marta Antonio Carlos Angel Josefa Pablo Marta Carmen Sergio Jose Francisco Miguel Lucia Lucia Paula Miguel Carmen Maria Isabel Fernando Alejandro Jorge Javier,a n l n a o s l a o a n o e o l a a a l n a l o o e r,27,22~30,Output: a n l n a o s l a o a n o e o l a a a l n a a l o e o e r,210,179,31
Isabel Manuel Alberto Maria Marta Alejandro Miguel Antonio Angel Jorge Sergio Manuel Lucia Alvaro Antonio Jose Juan Antonio Marta Francisco Francisco Francisco,l l o a a o l o l e o l a o o e n o a o o o,22,22~30,Output: l l o a a o l o l e o l a o o e n o a o o o o,200,175,25
Antonio Alejandro Manuel Sergio Pablo Javier Francisco Josefa Carlos Maria Jose Alvaro Carmen Sergio Sergio Paula Carmen Angel Fernando Jesus Francisco Francisco Carmen Sergio,o o l o o r o a s a e o n o o a n l o s o o n o,24,22~30,Output: o o l o o r a s a e o n o o a n l o s o o o n o,202,176,26
Lucia Sergio Josefa Paula Maria Alejandro Antonia Marta Alberto Jose Javier Jesus Jose Isabel Alejandro Francisco Manuel Miguel Pablo Antonia Manuel Manuel Angel Paula Carlos Francisco Antonia Jorge Antonio,a o a a a o a a o e r s e l o o l l o a l l l a s o a e o,29,22~30,Output: a o a a a o a a o e r s e l o o l l l l a s o a a o o,212,183,29
Alejandro Antonio Maria Marta Lucia Paula Josefa Lucia Jose Dolores Miguel Angel Jose Alvaro Marta Antonia Francisco Sergio Fernando Sergio Dolores Javier Isabel Javier Jose Alvaro,o o a a a a a a e s l l e o a a o o o o s r l r e o,26,22~30,Output: o o a a a a a a e s l l e o a a o o o o s r o s s r o l r l r e o,220,185,35
Jorge Pablo Jesus Josefa Sergio Sergio Juan Jose Francisco Alvaro Sergio Manuel Alberto Josefa Angel Carlos Isabel Sergio Lucia Pablo Jesus Alvaro,e o s a o o n e o o o l o a l s l o a o s o,22,22~30,Output: e o s a o o n e o o o l o a l s l o a o s o,201,177,24
Jorge Alvaro Carmen Alberto Francisco Jose Lucia Maria Angel Alejandro Alejandro Carlos Fernando Paula Angel Paula Miguel Alejandro Manuel Lucia Paula Francisco Fernando Pablo Manuel,e o n o o e a a l o o s o a l a l o l a a o o o l,25,22~30,Output: e o n o o e a a l o o s o a l a l o o l a o o o o l,204,176,28
Marta Isabel Marta Fernando Josefa Angel Lucia Javier Isabel Antonia Alberto Jose Pablo Marta Francisco Lucia Alejandro Manuel Juan Maria Francisco Alvaro Antonia Juan Juan Lucia Miguel Jose Carmen,a l a o a l a r l a o e o a o a o l n a o o a n n a l e n,29,22~30,Output: a l a o a l a r l a o e o a o a o l o l a a o a n a a a l e e n,220,186,34
Isabel Maria Manuel Antonia Antonio Angel Marta Sergio Miguel Antonio Marta Juan Carlos Paula Antonia Pablo Jesus Maria Antonio Alberto Francisco Javier Jorge Alvaro Josefa Jesus Pablo Lucia Francisco,l a l a o l a o l o a n s a a o s a o o o r e o a s o a o,29,22~30,Output: l a l a o l a o l o a n s a a o s a a o o o r a a s o a o,216,185,31
Jorge Carmen Josefa Jose Miguel Lucia Alvaro Jorge Fernando Alejandro Miguel Alvaro Javier Sergio Maria Jesus Antonia Pablo Javier Francisco Juan Josefa Antonio Angel Jose Juan Fernando Antonio Antonia,e n a e l a o e o o l o r o a s a o r o n a o l e n o o a,29,22~30,Output: e n a e l a o e o o l o r o a s n a o r o n a o e n o a,216,186,30
Sergio Dolores Fernando Sergio Maria Juan Carmen Sergio Juan Antonio Carmen Javier Josefa Lucia Jose Javier Manuel Jesus Miguel Lucia Francisco Josefa Miguel Francisco Pablo Dolores,o s o o a n n o n o n r a a e r l s l a o a l o o s,26,22~30,Output: o s o o a n n o n o n r a a e e l s l a o a l o s,206,179,27
Maria Jose Pablo Jesus Fernando Francisco Angel Sergio Jorge Sergio Jorge Maria Isabel Javier Isabel Manuel Alvaro Jose Fernando Jose Javier Juan Miguel Marta,a e o s o o l o e o e a l r l l o e o e r n l a,24,22~30,Output: a e o s o o l o e o e a l r l l o e o e r n l a,202,176,26
Maria Carmen Jesus Alberto Marta Carmen Carlos Francisco Manuel Carmen Antonia Josefa Antonio Jose Manuel Dolores Fernando Miguel Jose Angel Jorge Antonia Marta,a n s o a n s o l n a a o e l s o l e l e a a,23,22~30,Output: a n s o a n s o l n a a o e l s o e l e a a,202,178,24
Dolores Fernando Angel Lucia Isabel Alvaro Alvaro Marta Juan Marta Maria Lucia Josefa Fernando Antonia Antonio Juan Fernando Lucia Antonio Manuel Jesus Pablo Paula Alvaro Miguel,s o l a l o o a n a a a a o a o n o a o l s o a o l,26,22~30,Output: s o l a l o o a n a a a a o o a o n o a o l o l a o l,215,186,29
Miguel Carmen Manuel Jose Antonio Josefa Dolores Antonio Maria Jose Isabel Javier Alejandro Jose Miguel Lucia Miguel Miguel Isabel Jose Alejandro Jesus Jose Lucia Marta,l n l e o a s o a e l r o e l a l l l e o s e a a,25,22~30,Output: l n l e o a s o a e l r o e l a l l l e e o s e a a,205,177,28
Alberto Josefa Sergio Maria Isabel Sergio Isabel Alberto Fernando Carmen Antonio Sergio Carmen Alvaro Angel Josefa Sergio Javier Paula Isabel Pablo Carlos,o a o a l o l o o n o o n o l a o r a l o s,22,22~30,Output: o a o a l o o o n o o o l a a o o r a l o s,199,175,24
Alvaro Miguel Jesus Alvaro Juan Carmen Antonio Lucia Fernando Alberto Alejandro Sergio Alvaro Alejandro Maria Miguel Miguel Miguel Jose Manuel Isabel Alvaro Antonio Juan Jose Jesus,o l s o n n o a o o o o o o a l l l e l l o o n e s,26,22~30,Output: o l s o n n o a o o o o o a l l l l e l l o o n e s,211,183,28
Manuel Lucia Juan Miguel Juan Lucia Antonio Alberto Jesus Alvaro Alberto Javier Carmen Jose Manuel Josefa Alvaro Javier Dolores Antonio Isabel Antonio Antonio Carmen Manuel Antonio Dolores,l a n l n a o o s o o r n e l a o r s o l o o n l o s,27,22~30,Output: l a n l n a o o s o o r n e l a o r r s o l a o o n l o s,214,183,31
Antonia Isabel Juan Manuel Pablo Jose Sergio Javier Antonio Alberto Paula Jorge Jorge Alvaro Miguel Antonio Dolores Jose Carlos Javier Josefa Juan Paula Jesus Javier Marta Maria,a l n l o e o r o o a e e o l o s e s r a n a s r a a,27,22~30,Output: a l n l o e o r o o a e e o l o s e s r a n a s r a a,211,182,29
Francisco Alberto Jesus Jose Francisco Manuel Jorge Fernando Manuel Alvaro Jesus Marta Jorge Sergio Miguel Miguel Maria Jose Dolores Pablo Miguel Jesus Juan Francisco Alvaro Fernando Lucia Paula Angel,o o s e o l e o l o s a e o l l a e s o l s n o o o a a l,29,22~30,Output: o o s e o l e o l o s a e o l l a e s o l s n o a a l,213,184,29
Antonio Pablo Antonia Alberto Isabel Maria Jorge Paula Alvaro Miguel Jorge Fernando Paula Manuel Antonio Antonia Fernando Alejandro Sergio Carlos Antonia Paula Sergio Marta Fernando Alejandro Manuel,o o a o l a e a o l e o a l o a o o o s a a o a o o l,27,22~30,Output: o o a o l a e a o l e o a l o a o o e o s a a o o a a o e o l,215,182,33
Javier Paula Sergio Pablo Jose Miguel Angel Miguel Juan Angel Carmen Alberto Carlos Javier Angel Jesus Maria Carmen Jesus Marta Jose Lucia Dolores Miguel Carlos Juan Carlos Juan,r a o o e l l l n l n o s r l s a n s a e a s l s n s n,28,22~30,Output: r a o o e l l l n l n o s r l s a a n s a e a s s l s l s n,211,179,32
Manuel Maria Paula Jose Dolores Alberto Fernando Lucia Alejandro Angel Javier Jesus Jose Javier Jose Josefa Jorge Marta Miguel Lucia Lucia Dolores,l a a e s o o a o l r s e r e a e a l a a s,22,22~30,Output: l a a e s o o a o l r s e r e a e a l a a s,199,175,24
Antonia Isabel Carmen Antonia Javier Jose Jesus Carmen Pablo Alvaro Francisco Alejandro Josefa Alberto Antonio Carlos Paula Javier Manuel Jesus Alejandro Carmen Alvaro Alejandro Alberto Miguel Pablo,a l n a r e s n o o o o a o o s a r l s o n o o o l o,27,22~30,Output: a l n a r e s n o o o o a o o s a r l l s o n o o o l o,213,183,30
Jose Paula Paula Alberto Manuel Antonio Isabel Maria Carmen Jorge Lucia Carlos Maria Carlos Juan Jose Manuel Alberto Pablo Josefa Angel Jose Francisco,e a a o l o l a n e a s a s n e l o o a l e o,23,22~30,Output: e a a o l o l a n e a s a s n e l o o a l e o,198,173,25
Sergio Carlos Francisco Carmen Josefa Angel Carmen Paula Javier Pablo Dolores Alberto Angel Manuel Manuel Fernando Jose Carlos Alejandro Jose Dolores Alberto Marta Fernando Miguel,o s o n a l n a r o s o l l l o e s o e s o a o l,25,22~30,Output: o s o n a l n a r o s o l l l o e s o e s o a o l,205,178,27
Antonia Alberto Jose Carlos Alberto Jose Alejandro Alberto Alejandro Marta Miguel Carmen Alberto Pablo Dolores Jorge Dolores Alvaro Carmen Manuel Antonio Isabel Miguel Alvaro Carlos,a o e s o e o o o a l n o o s e s o n l o l l o s,25,22~30,Output: a o e s o e o o e a l n o o s e s o n l o l l o s,209,182,27
Isabel Jorge Alejandro Manuel Carlos Marta Josefa Dolores Antonia Antonia Angel Alvaro Francisco Javier Sergio Jorge Manuel Alvaro Antonio Pablo Carmen Pablo Marta Alberto Maria Manuel Dolores Dolores,l e o l s a a s a a l o o r o e l o o o n o a o a l s s,28,22~30,Output: l e o l s a a s a a l o o r o e l o o o o n o a o a s s,219,189,30
Antonia Maria Jose Javier Alejandro Antonio Alberto Fernando Jose Dolores Miguel Carmen Manuel Alvaro Maria Jose Paula Alvaro Juan Paula Jose Jorge Marta,a a e r o o o o e s l n l o a e a o n a e e a,23,22~30,Output: a a e r o o o o e s l n n l o a a e a o n a e e a,206,179,27
Jesus Angel Jorge Juan Dolores Jose Jose Josefa Sergio Jose Pablo Carlos Dolores Josefa Lucia Carmen Marta Miguel Jesus Carlos Lucia Antonia Marta Francisco Alvaro Carmen Alberto Pablo Sergio,s l e n s e e a o e o s s a a n a l s s a a a o o n o o o,29,22~30,Output: s l e n s e e a o e o s s a a n a a l s a a o n o o o,216,187,29
Javier Javier Alvaro Jesus Pablo Javier Lucia Miguel Marta Maria Jose Manuel Angel Isabel Fernando Alejandro Pablo Carmen Francisco Marta Paula Francisco Alberto Jose Lucia,r r o s o r a l a a e l l l o o o n o a a o o e a,25,22~30,Output: r r o s o r a l a a e l l l o o o n o a o o a e a,205,178,27
Dolores Jose Jose Jesus Francisco Francisco Carlos Antonio Carlos Carlos Javier Manuel Josefa Josefa Jose Dolores Dolores Lucia Paula Isabel Antonia Fernando Sergio Alvaro Miguel Paula Miguel Josefa Javier,s e e s o o s o s s r l a a e s s a a l a o o o l a l a r,29,22~30,Output: s e e s o o s o s s r l a a e s s a a o o o l a l a r,216,187,29
Miguel Josefa Paula Francisco Francisco Angel Jose Jorge Angel Angel Pablo Dolores Jesus Dolores Alejandro Carlos Carlos Maria Carmen Carmen Alejandro Marta,l a a o o l e e l l o s s s o s s a n n o a,22,22~30,Output: l a a o o l e e l l o s s s o s s a n n o a,199,175,24
Carlos Josefa Antonia Maria Alvaro Jose Miguel Josefa Juan Alberto Antonio Carmen Dolores Lucia Alvaro Jesus Isabel Jorge Carlos Isabel Jose Antonio Alvaro Jose Javier Francisco,s a a a o e l a n o o n s a o s l e s l e o o e r o,26,22~30,Output: s a a a o e l a n o o n s a o s l e s l e o o e r o,213,185,28
Paula Isabel Antonio Juan Jesus Jorge Alvaro Paula Lucia Angel Javier Manuel Carlos Lucia Antonio Manuel Antonia Antonio Manuel Francisco Dolores Paula Antonia Antonia,a l o n s e o a a l r l s a o l a o l o s a a a,24,22~30,Output: a l o n s e o a a l r l s a o l a o o o s a a a,205,179,26
Francisco Jose Carlos Lucia Jesus Sergio Marta Jose Javier Jorge Sergio Jorge Alvaro Miguel Alvaro Jorge Pablo Carmen Fernando Carlos Carlos Javier Sergio,o e s a s o a e r e o e o l o e o n o s s r o,23,22~30,Output: o e s a s o a e r e o e o l o e o n o s s r o,202,177,25
Javier Isabel Marta Manuel Carmen Jose Maria Angel Jose Jose Dolores Antonio Angel Francisco Jorge Jose Carlos Francisco Jesus Alberto Miguel Fernando Marta Manuel Manuel Antonio Alberto Alberto Javier,r l a l n e a l e e s o l o e e s o s o l o a l l o o o r,29,22~30,Output: r l a l n e a l e e s o l o e e s o s o o l a o o r,209,181,28
Dolores Javier Dolores Alvaro Marta Paula Alejandro Alvaro Carmen Antonia Pablo Alberto Paula Miguel Alvaro Pablo Alberto Jose Angel Juan Alberto Jesus Marta Angel Paula Carmen Alberto,s r s o a a o o n a o o a l o o o e l n o s a l a n o,27,22~30,Output: s r s o a a o o n a o o a l o o o e l n o s a l a n o,216,187,29
Alvaro Juan Josefa Francisco Alvaro Alvaro Carlos Carlos Carmen Pablo Miguel Antonia Antonia Jorge Miguel Maria Dolores Alvaro Pablo Carlos Jorge Jorge Juan Sergio Paula Miguel,o n a o o o s s n o l a a e l a s o o s e e n o a l,26,22~30,Output: o n a o o o s s n o l a a e l a s o o o e e n o a l,215,187,28
Manuel Javier Juan Alvaro Jesus Jose Manuel Dolores Jesus Carlos Jesus Pablo Jorge Alberto Fernando Jose Paula Antonio Fernando Javier Antonia Paula Miguel Antonio,l r n o s e l s s s s o e o o e a o o r a a l o,24,22~30,Output: l r n o s e l s s s o e o o e e a o o r a a l o,203,177,26
Jose Carlos Paula Alberto Alvaro Antonia Jose Fernando Juan Jose Alejandro Juan Lucia Manuel Alejandro Sergio Fernando Manuel Fernando Antonia Javier Antonio Fernando,e s a o o a e o n e o n a l o o o l o a r o o,23,22~30,Output: e s a o o a e o n e o n a l o o o o a r o o,200,176,24
Alberto Maria Sergio Carlos Jose Manuel Jose Alvaro Antonia Manuel Juan Dolores Isabel Isabel Carmen Dolores Dolores Alvaro Sergio Dolores Isabel Lucia Lucia Lucia Josefa,o a o s e l e o a l n s l l n s s o o s l a a a a,25,22~30,Output: o a o s e l e o a l n s l l n s s o o s l a a a a,211,184,27
Carlos Paula Juan Maria Jose Javier Angel Jose Dolores Jorge Francisco Angel Sergio Angel Marta Jose Jesus Sergio Dolores Antonia Manuel Fernando Fernando Manuel Jorge Fernando Angel Carmen,s a n a e r l e s e o l o l a e s o s a l o o l e o l n,28,22~30,Output: s a n a e r l e s e o o l o a e s o s a a l o o l e o l n,212,181,31
Dolores Dolores Alvaro Alberto Antonia Maria Angel Paula Marta Isabel Alberto Jose Alvaro Sergio Fernando Isabel Lucia Alejandro Josefa Jose Javier Jesus Javier Paula Sergio Alberto Javier Antonia Antonio,s s o o a a l a a l o e o o o l a o a e r s r a o o r a o,29,22~30,Output: s s o o a a l a a l o e o o o l a o e e r s o o a a o o,218,188,30
Maria Jose Carmen Marta Jorge Antonia Fernando Alvaro Manuel Paula Josefa Carmen Maria Alvaro Antonio Francisco Jose Miguel Antonia Javier Antonia Maria Angel,a e n a e a o o l a a n a o o o e l a r a a l,23,22~30,Output: a e n a e a o o l a a n a o o o e e l a r a a l,207,181,26
Antonia Juan Isabel Josefa Lucia Carlos Carlos Isabel Marta Miguel Maria Jose Antonia Angel Manuel Pablo Francisco Sergio Fernando Marta Antonio Isabel Manuel,a n l a a s s l a l a e a l l o o o o a o l l,23,22~30,Output: a n l a a s s l a l a e a l l o o o o o a o l,202,177,25
Alejandro Marta Jorge Javier Marta Jose Josefa Maria Manuel Jose Juan Paula Paula Josefa Alberto Pablo Alejandro Antonia Jose Juan Antonio Jorge Angel Antonio Marta Antonia,o a e r a e a a l e n a a a o o o a e n o e l o a a,26,22~30,Output: o a e r a e a a l e a a a a o o o a e a o a a a,208,182,26
Antonia Jose Angel Isabel Angel Jorge Carmen Paula Paula Alejandro Jose Javier Antonia Angel Alvaro Alberto Carlos Manuel Jose Carlos Javier Marta,a e l l l e n a a o e r a l o o s l e s r a,22,22~30,Output: a e l l l e n a a o e r a l o o s l e s r a,200,176,24
Jose Pablo Alberto Fernando Maria Dolores Miguel Lucia Maria Marta Jose Paula Lucia Alberto Maria Miguel Sergio Javier Juan Angel Sergio Marta Javier Antonio Fernando Miguel Alejandro Pablo,e o o o a s l a a a e a a o a l o r n l o a r o o l o o,28,22~30,Output: e o o o a s l a a a e a a o a l o r n l o a r o o l,208,180,28
Angel Alejandro Francisco Alvaro Maria Alejandro Alberto Francisco Antonia Lucia Marta Alvaro Fernando Antonia Dolores Francisco Juan Dolores Miguel Paula Angel Carmen Francisco Paula,l o o o a o o o a a a o o a s o n s l a l n o a,24,22~30,Output: l o o o a o o o a a a o o a s o a n s l a n o a,208,182,26
Alejandro Dolores Antonia Francisco Sergio Marta Carmen Maria Jorge Javier Josefa Paula Marta Carmen Dolores Alejandro Alberto Carlos Marta Alejandro Antonia Jorge Sergio Antonio Josefa Lucia Jose Marta,o s a o o a n a e r a a a n s o o s a o a e o o a a e a,28,22~30,Output: o s a o o a n a e r a a a n s o o o s a o e a a e a,215,187,28
Paula Josefa Alejandro Miguel Alejandro Sergio Javier Marta Paula Francisco Marta Miguel Paula Fernando Juan Jorge Manuel Francisco Paula Manuel Jose Josefa Carlos Alberto Francisco Antonio,a a o l o o r a a o a l a o n e l o a l e a s o o o,26,22~30,Output: a a o l o o r a a o a l a o n a e l o a l e a s o o,207,179,28
Jose Antonia Marta Jose Dolores Maria Alberto Antonio Miguel Maria Francisco Isabel Carmen Maria Josefa Marta Sergio Manuel Lucia Alberto Jesus Jorge Antonio,e a a e s a o o l a o l n a a a o l a o s e o,23,22~30,Output: e a a e s a o o l a o l n a a a o l a s e o,201,177,24
Antonia Jesus Maria Javier Marta Manuel Alvaro Lucia Isabel Paula Sergio Carlos Miguel Josefa Alejandro Alvaro Pablo Sergio Miguel Manuel Javier Alvaro Josefa Alberto,a s a r a l o a l a o s l a o o o o l l r o a o,24,22~30,Output: a s a r a l o a l a o s l l a o o o l l r o a o,209,183,26
Pablo Fernando Alvaro Javier Carlos Fernando Miguel Miguel Maria Marta Alberto Pablo Maria Manuel Manuel Lucia Jose Marta Paula Maria Jose Lucia,o o o r s o l l a a o o a l l a e a a a e a,22,22~30,Output: o o o r s o l l a a o o a l l a e a a a e a,199,175,24
Jose Sergio Angel Javier Alejandro Jose Maria Alvaro Francisco Angel Maria Carmen Jose Alberto Josefa Paula Carmen Dolores Angel Lucia Antonia Miguel Juan Javier Alejandro Carmen Fernando Angel,e o l r o e a o o l a n e o a a n s l a a l n r o n o l,28,22~30,Output: e o l r o e a o o l a n e o a a n s l a l n r o n,209,182,27
Manuel Alberto Isabel Lucia Angel Alberto Alberto Jose Alvaro Dolores Lucia Antonia Fernando Juan Carmen Josefa Alejandro Jose Carlos Paula Lucia Francisco Lucia Alejandro,l o l a l o o e o s a a o n n a o e s a a o a o,24,22~30,Output: l o l a l o o e o s a a o n n a o e s a a o a o,204,178,26
Jose Antonio Carlos Paula Sergio Manuel Antonia Josefa Pablo Isabel Paula Javier Marta Alejandro Alvaro Carmen Fernando Alejandro Antonia Josefa Francisco Jose,e o s a o l a a o l a r a o o n o o a a o e,22,22~30,Output: e o s a o l a a o l a r a o o n o a a o e,201,178,23
Antonio Sergio Pablo Carlos Antonia Alejandro Marta Jose Jose Francisco Alvaro Carlos Jose Antonio Juan Jorge Jesus Pablo Fernando Juan Isabel Carlos Pablo Miguel Jorge Jesus Fernando,o o o s a o a e e o o s e o n e s o o n l s o l e s o,27,22~30,Output: o o o s a o a e e o o s e o n e s s o o n l s o l e s s o,211,180,31
Alejandro Francisco Jorge Angel Josefa Jose Marta Alvaro Francisco Fernando Juan Maria Javier Javier Alvaro Carlos Jose Marta Miguel Josefa Manuel Alberto Marta Juan Manuel Antonio Fernando Carmen,o o e l a e a o o o n a r r o s e a l a l o a n l o o n,28,22~30,Output: o o e l a e a o o o n a r o o s e a l a l o a a n o o n,216,186,30
Carmen Jose Miguel Paula Lucia Sergio Manuel Paula Jorge Francisco Antonio Carmen Paula Isabel Alejandro Jesus Jose Dolores Antonio Lucia Jorge Alberto Isabel Alejandro Josefa Carmen,n e l a a o l a e o o n a l o s e s o a e o l o a n,26,22~30,Output: n e l a a o l a e o o n a l o o a a a e o a o a a e n,206,177,29
Jorge Alberto Manuel Carmen Jorge Javier Juan Jose Pablo Pablo Alejandro Antonio Carlos Alberto Jose Sergio Marta Alvaro Antonio Jose Lucia Jesus Maria Jose Marta Isabel Lucia Lucia,e o l n e r n e o o o o s o e o a o o e a s a e a l a a,28,22~30,Output: e o l n e r n e o o o o s o e o a o o e a a l a a,208,181,27
Dolores Fernando Sergio Josefa Alejandro Francisco Fernando Manuel Sergio Alejandro Antonio Fernando Javier Juan Maria Isabel Marta Maria Jorge Jose Fernando Fernando Carmen Juan Antonio,s o o a o o o l o o o o r n a l a a e e o o n n o,25,22~30,Output: s o o a o o o l o o o o r n a a a e e o o n n o,203,177,26
Carmen Isabel Lucia Pablo Manuel Pablo Alberto Paula Alejandro Marta Jorge Francisco Carlos Carlos Paula Jesus Alejandro Juan Dolores Pablo Francisco Jorge Miguel Dolores Maria Angel Carmen Alejandro,n l a o l o o a o a e o s s a s o n s o o e l s a l n o,28,22~30,Output: n l a o l o o a o a e o o s s a s o n o o o e e a l n o,210,180,30
Paula Pablo Carmen Miguel Dolores Sergio Javier Antonia Alberto Manuel Alejandro Antonia Paula Juan Sergio Alberto Alejandro Dolores Jesus Fernando Maria Javier,a o n l s o r a o l o a a n o o o s s o a r,22,22~30,Output: a o n l s o r a o l o a a n o o e s s o a,198,175,23
Angel Jose Alejandro Francisco Fernando Maria Miguel Alberto Lucia Antonia Paula Marta Jose Josefa Jorge Javier Alvaro Antonio Manuel Antonia Fernando Javier Marta Carlos Carlos Manuel Jose Alejandro,l e o o o a l o a a a a e a e r o o l a o r a s s l e o,28,22~30,Output: l e o o o a l o a a a a e a e r o o l a o s s l e o,212,184,28
Miguel Jesus Sergio Paula Fernando Maria Alberto Carlos Francisco Pablo Pablo Alvaro Carlos Antonia Miguel Miguel Antonio Dolores Francisco Carmen Antonio Fernando Miguel Antonio Fernando Antonia Miguel Jose,l s o a o a o s o o o o s a l l o s o n o o l o o a l e,28,22~30,Output: l s o a o a o s o o o o s a l l o s o n o o l o o a l e,212,182,30
Maria Alberto Dolores Francisco Angel Alberto Juan Carmen Francisco Jesus Alberto Lucia Alvaro Jesus Sergio Alvaro Pablo Antonio Jorge Isabel Fernando Alvaro Antonia,a o s o l o n n o s o a o s o o o o e l o o a,23,22~30,Output: a o s o l o n n o s o a o s o o o e l o o a,204,180,24
Jesus Jose Alvaro Alberto Manuel Marta Alvaro Dolores Antonio Miguel Dolores Marta Isabel Alejandro Jorge Alvaro Jorge Maria Alejandro Isabel Angel Javier Fernando Lucia Francisco,s e o o l a o s o l s a l o e o e a o l l r o a o,25,22~30,Output: s e o o l a o s o l s a l o e o e a o l l r o a o,211,184,27
Dolores Lucia Paula Lucia Fernando Isabel Jose Dolores Francisco Juan Jose Paula Fernando Francisco Paula Marta Lucia Sergio Alberto Josefa Pablo Juan Juan Carmen Juan Pablo,s a a a o l e s o n e a o o a a a o o a o n n n n o,26,22~30,Output: s a a a o l e s o n e a o o a a a o o a o n n n o,206,179,27
Carmen Carlos Juan Jorge Marta Francisco Marta Josefa Jesus Jose Fernando Dolores Jose Jesus Pablo Lucia Angel Francisco Jose Paula Manuel Paula Jose Marta Jesus Carmen Pablo Jose Manuel,n s n e a o a a s e o s e s o a l o e a l a e a s n o e l,29,22~30,Output: n s n e a o a a s s e o s e s o a l o e e a l a e a s n o e l,216,183,33
Alberto Manuel Maria Maria Jesus Jose Carlos Isabel Alejandro Jorge Alejandro Angel Marta Miguel Carlos Dolores Alvaro Sergio Dolores Carlos Jesus Manuel,o l a a s e s l o e o l a l s s o o s s s l,22,22~30,Output: o l a a s e s l o e o l a l s o o s s l,198,176,22
Dolores Alejandro Carlos Paula Alejandro Marta Jesus Marta Juan Pablo Juan Jesus Angel Marta Javier Juan Dolores Jorge Carmen Pablo Jesus Maria Alberto Jorge Juan Isabel Fernando Francisco Antonia,s o s a o a s a n o n s l a r n s e n o s a o e n l o o a,29,22~30,Output: s o s a o a s a n o n s l a r n s e n o e e a o e n l o o a,216,184,32
Josefa Marta Jorge Marta Francisco Carmen Antonio Dolores Carlos Fernando,a a e a o n o s s o,10,8~15,Output: a a e a o n o s s o,175,163,12
Antonia Jesus Jose Jesus Fernando Carmen Angel Manuel Jose Alejandro Antonia Isabel Alejandro Carmen,a s e s o n l l e o a l o n,14,8~15,Output: a s e s o n l l e o a l o n,181,165,16
Pablo Isabel Jorge Carlos Marta Maria Alejandro Carlos Manuel Jose Carmen Sergio,o l e s a a o s l e n o,12,8~15,Output: o l e s a a o s l e n o,176,162,14
Miguel Isabel Alvaro Marta Lucia Antonio Francisco Paula,l l o a a o o a,8,8~15,Output: l l o a a o o a,170,160,10
Maria Fernando Manuel Dolores Alejandro Jose Carlos Carmen,a o l s o e s n,8,8~15,Output: a o l s o e s n,168,158,10
Francisco Fernando Josefa Paula Alvaro Francisco Paula Dolores Angel Antonio Carmen Alberto Antonia Jesus,o o a a o o a s l o n o a s,14,8~15,Output: o o a a o o a s l o n o a s,184,168,16
Josefa Lucia Sergio Josefa Dolores Manuel Antonio Miguel Pablo Lucia Antonia Marta Jesus Francisco,a a o a s l o l o a a a s o,14,8~15,Output: a a o a s l o l o a a s o,183,168,15
Sergio Paula Jose Sergio Miguel Alvaro Marta Maria,o a e o l o a a,8,8~15,Output: o a e o l o a a,170,160,10
Jose Juan Maria Alvaro Isabel Francisco Paula Isabel Jorge Jesus Maria,e n a o l o a l e s a,11,8~15,Output: e n a o l o a l e s a,175,162,13
Antonio Maria Jorge Antonio Carmen Francisco Francisco Carmen Manuel Alberto Alberto Dolores Angel Jose,o a e o n o o n l o o s l e,14,8~15,Output: o a e o n o o n l o o s l e,180,164,16
Antonio Alberto Maria Maria Antonio Jesus Jose Carlos Jesus Angel Jorge Juan Dolores Manuel,o o a a o s e s s l e n s l,14,8~15,Output: o o a a o s e s s l e n l,179,164,15
Antonio Jorge Carlos Javier Antonia Dolores Isabel Jose,o e s r a s l e,8,8~15,Output: o e s r a s l e,169,159,10
Fernando Pablo Angel Angel Carmen Carmen Angel Alejandro Alberto Fernando Alejandro,o o l l n n l o o o o,11,8~15,Output: o o l l n n l o o o o,173,160,13
Carlos Carlos Manuel Miguel Javier Pablo Carlos Manuel Alberto Manuel Jorge,s s l l r o s l o l e,11,8~15,Output: s s l l r o s l o l e,173,160,13
Antonio Manuel Jesus Lucia Antonia Paula Jesus Marta Jorge Carlos Jorge,o l s a a a s a e s e,11,8~15,Output: o l s a a a s a e s e,175,162,13
Jose Miguel Paula Paula Alejandro Javier Fernando Maria,e l a a o r o a,8,8~15,Output: e l a a o r o a,167,157,10
Fernando Dolores Jose Carmen Josefa Lucia Angel Lucia,o s e n a a l a,8,8~15,Output: o s e n a a l a,169,159,10
Marta Carlos Paula Marta Antonia Dolores Marta Miguel Alejandro Isabel Maria,a s a a a s a l o l a,11,8~15,Output: a s a a a s a l o l a,178,165,13
Juan Alejandro Jesus Josefa Fernando Carmen Angel Paula,n o s a o n l a,8,8~15,Output: n o s a o n l a,168,158,10
Isabel Dolores Jose Antonia Antonia Alberto Jesus Jesus Jorge,l s e a a o s s e,9,8~15,Output: l s e a a o s s e,172,161,11
Pablo Jesus Jesus Alberto Miguel Javier Fernando Pablo Dolores Juan Antonia Javier Jorge,o s s o l r o o s n a r e,13,8~15,Output: o s s o l r o o s n a r e,179,164,15
Juan Sergio Paula Antonio Juan Josefa Jorge Jose Antonio Marta Juan Josefa Jesus Carlos,n o a o n a e e o a n a s s,14,8~15,Output: n o a o n a e e o a n a s s,182,166,16
Francisco Alvaro Paula Alberto Jose Antonio Carmen Carlos Angel Dolores,o o a o e o n s l s,10,8~15,Output: o o a o e o n s l s,174,162,12
Carlos Jose Isabel Josefa Dolores Jesus Angel Carlos Carmen Jesus Juan Alejandro,s e l a s s l s n s n o,12,8~15,Output: s e l a s s l s n s n o,177,163,14
Miguel Jorge Jorge Alvaro Fernando Jorge Lucia Alvaro Jose Jorge Carmen Sergio Jose Juan,l e e o o e a o e e n o e n,14,8~15,Output: l e e o o e a o e e n o e n,183,167,16
Pablo Juan Juan Paula Sergio Isabel Francisco Alejandro,o n n a o l o o,8,8~15,Output: o n n a o l o o,167,157,10
Carmen Alvaro Carlos Jose Maria Javier Isabel Antonia Fernando Carlos Jorge,n o s e a r l a o s e,11,8~15,Output: n o s e a r l a o s e,176,163,13
Miguel Paula Isabel Angel Maria Paula Fernando Jose Josefa,l a l l a a o e a,9,8~15,Output: l a l l a a o e a,170,159,11
Jose Jose Carmen Miguel Jose Jose Carmen Javier Jesus Josefa Javier Jose Jesus,e e n l e e n r s a r e s,13,8~15,Output: e e n l e e n r s a r e s,178,163,15
Alejandro Juan Paula Marta Dolores Paula Carlos Manuel Antonio Alvaro Jesus Josefa Antonio Alejandro,o n a a s a s l o o s a o o,14,8~15,Output: o n a a s a s l o o s a o o,184,168,16
Jesus Antonio Pablo Alberto Alvaro Carmen Jorge Isabel Alvaro,s o o o o n e l o,9,8~15,Output: s o o o o n e l o,173,162,11
Alvaro Jose Alvaro Jesus Marta Francisco Miguel Carlos,o e o s a o l s,8,8~15,Output: o e o s a o l s,172,162,10
Isabel Antonio Francisco Antonio Antonia Antonia Sergio Francisco Carmen Jesus Juan Maria,l o o o a a o o n s n a,12,8~15,Output: l o o o a a o o n s n a,177,163,14
Marta Jose Lucia Jesus Josefa Alvaro Dolores Francisco Juan Jesus,a e a s a o s o n s,10,8~15,Output: a e a s a o s o n s,176,164,12
Francisco Marta Fernando Angel Carlos Manuel Alberto Javier Jesus Angel Jose Maria,o a o l s l o r s l e a,12,8~15,Output: o a o l s l o r s l e a,176,162,14
Marta Pablo Lucia Jose Paula Fernando Carlos Carlos,a o a e a o s s,8,8~15,Output: a o a e a o s s,168,158,10
Antonia Javier Angel Isabel Sergio Dolores Dolores Sergio Fernando Alvaro Isabel Miguel Alberto Jose,a r l l o s s o o o l l o e,14,8~15,Output: a r l l o s s o o o l l o e,184,168,16
Marta Carlos Javier Manuel Angel Francisco Sergio Pablo,a s r l l o o o,8,8~15,Output: a s r l l o o o,168,158,10
Lucia Marta Javier Manuel Fernando Antonio Jose Juan Fernando Carmen Francisco Fernando,a a r l o o e n o n o o,12,8~15,Output: a a r l o o e n o n o o,176,162,14
Paula Alejandro Isabel Carlos Javier Miguel Carmen Paula Jorge Juan,a o l s r l n a e n,10,8~15,Output: a o l s r l n a e n,171,159,12
Carlos Sergio Jesus Angel Antonia Juan Josefa Fernando,s o s l a n a o,8,8~15,Output: s o s l a n a o,169,159,10
Dolores Jorge Sergio Jose Jose Antonia Carlos Paula,s e o e e a s a,8,8~15,Output: s e o e e a s a,169,159,10
Miguel Pablo Lucia Jose Josefa Carmen Jose Carlos Maria Alberto Maria Dolores Josefa,l o a e a n e s a o a s a,13,8~15,Output: l o a e a n e s a o a s a,180,165,15
Paula Jorge Alvaro Lucia Jose Miguel Angel Alvaro Fernando,a e o a e l l o o,9,8~15,Output: a e o a e l l o o,173,162,11
Carmen Carlos Fernando Miguel Francisco Sergio Juan Angel Jose Marta Carlos Marta Javier,n s o l o o n l e a s a r,13,8~15,Output: n s o l o o n l e a s a r,179,164,15
Carmen Maria Alvaro Fernando Jorge Alvaro Dolores Alejandro Juan Carlos Manuel,n a o o e o s o n s l,11,8~15,Output: n a o o e o s o n s l,178,165,13
Pablo Alvaro Lucia Jose Josefa Carlos Sergio Josefa Manuel Maria Marta Maria Isabel,o o a e a s o a l a a a l,13,8~15,Output: o o a e a s o a l a a a l,182,167,15
Angel Isabel Jose Jorge Maria Javier Manuel Pablo Lucia Carlos Fernando Carlos Antonio,l l e e a r l o a s o s o,13,8~15,Output: l l e e a r l o a s o s o,177,162,15
Jorge Antonia Dolores Angel Francisco Josefa Juan Isabel,e a s l o a n l,8,8~15,Output: e a s l o a n l,170,160,10
Marta Sergio Jorge Jose Javier Josefa Marta Jorge Fernando Paula Carmen,a o e e r a a e o a n,11,8~15,Output: a o e e r a a e o a n,176,163,13
Miguel Lucia Angel Miguel Alvaro Sergio Javier Marta Jorge,l a l l o o r a e,9,8~15,Output: l a l l o o r a e,172,161,11
Isabel Paula Sergio Pablo Antonia Fernando Maria Alberto Paula Angel,l a o o a o a o a l,10,8~15,Output: l a o o a o a o a l,172,160,12
Manuel Manuel Paula Marta Dolores Pablo Antonio Paula Maria Fernando Carmen,l l a a s o o a a o n,11,8~15,Output: l l a a s o o a a o n,175,162,13
Juan Paula Lucia Lucia Miguel Isabel Dolores Sergio Manuel Alberto Carmen,n a a a l l s o l o n,11,8~15,Output: n a a a l l s o l o n,174,161,13
Pablo Antonia Maria Angel Jose Lucia Carlos Carlos Carlos Maria Carmen,o a a l e a s s s a n,11,8~15,Output: o a a l e a s s s a n,174,161,13
Carmen Jose Jose Antonio Isabel Manuel Jorge Jorge Jose Marta Pablo Dolores,n e e o l l e e e a o s,12,8~15,Output: n e e o l l e e e a o s,177,163,14
Josefa Dolores Alvaro Carmen Isabel Dolores Jorge Antonia Sergio Alvaro Francisco Antonio Alberto,a s o n l s e a o o o o o,13,8~15,Output: a s o n l s e a o o o o o,185,170,15
Javier Paula Fernando Carlos Jorge Jose Fernando Angel Antonio Isabel Jorge Jorge Alejandro,r a o s e e o l o l e e o,13,8~15,Output: r a o s e e o l o l e e o,177,162,15
Paula Isabel Juan Carlos Carlos Jorge Antonio Lucia Paula Lucia Maria,a l n s s e o a a a a,11,8~15,Output: a l n s s e o a a a a,173,160,13
Antonio Jose Juan Paula Carmen Isabel Fernando Jorge Pablo Paula Manuel Antonia,o e n a n l o e o a l a,12,8~15,Output: o e n a n l o e o a l a,176,162,14
Isabel Paula Antonio Jose Marta Antonio Manuel Alejandro Dolores Josefa Francisco Alberto,l a o e a o l o s a o o,12,8~15,Output: l a o e a o l o s a o o,178,164,14
Alejandro Alvaro Jose Josefa Jesus Javier Fernando Angel Carlos Miguel Angel Antonia Pablo,o o e a s r o l s l l a o,13,8~15,Output: o o e a s r o l s l l a o,181,166,15
Jesus Alejandro Lucia Jorge Isabel Antonia Isabel Jesus Marta Carmen Antonia Antonio Angel Jose,s o a e l a l s a n a o l e,14,8~15,Output: s o a e l a l s a n a o l e,182,166,16
Antonio Carmen Alvaro Marta Fernando Alberto Fernando Angel Carmen Marta Javier Antonio Jose,o n o a o o o l n a r o e,13,8~15,Output: o n o a o o o l n a r o e,181,166,15
Miguel Paula Juan Paula Miguel Francisco Lucia Javier Paula Juan,l a n a l o a r a n,10,8~15,Output: l a n a l o a r a n,171,159,12
Juan Pablo Francisco Sergio Lucia Josefa Paula Lucia,n o o o a a a a,8,8~15,Output: n o o o a a a a,168,158,10
Manuel Juan Manuel Alejandro Jose Antonio Manuel Isabel Jose Antonia Angel,l n l o e o l l e a l,11,8~15,Output: l n l o e o l l e a l,174,161,13
Francisco Carmen Javier Josefa Antonia Lucia Josefa Angel Manuel Josefa Lucia,o n r a a a a l l a a,11,8~15,Output: o n r a a a a l l a a,177,164,13
Jorge Jose Josefa Alberto Francisco Antonio Carmen Paula Maria Paula Alberto,e e a o o o n a a a o,11,8~15,Output: e e a o o o n a a a o,174,161,13
Jose Sergio Paula Dolores Jesus Jesus Miguel Alberto Angel Manuel Carmen Jorge Jesus,e o a s s s l o l l n e s,13,8~15,Output: e o a s s s l o l l n e s,178,163,15
Angel Miguel Francisco Jesus Pablo Paula Antonio Manuel Jesus Jose Jose Sergio Jose,l l o s o a o l s e e o e,13,8~15,Output: l l o s o a o l s e e o e,177,162,15
Isabel Dolores Carlos Pablo Sergio Sergio Jorge Antonia Carlos Javier Josefa Jose,l s s o o o e a s r a e,12,8~15,Output: l s s o o o e a s r a e,178,164,14
Miguel Antonio Paula Juan Josefa Paula Dolores Marta Antonio Juan Alejandro Manuel Manuel Juan,l o a n a a s a o n o l l n,14,8~15,Output: l o a n a a s a o n o l l n,182,166,16
Carlos Josefa Alberto Fernando Antonio Sergio Fernando Jesus Paula,s a o o o o o s a,9,8~15,Output: s a o o o o o s a,170,159,11
Alejandro Josefa Jose Alberto Antonio Fernando Fernando Angel Javier Miguel Jose Sergio Jorge Jose,o a e o o o o l r l e o e e,14,8~15,Output: o a e o o o o l r l e o e e,180,164,16
