input,out,len,bins,pred,total-tokens,prompt-tokens,completion-tokens
Сінан Лео Христина Еліна Лукас Лукас Соломія Олівія Владислав Сарра Гордій Заріна Еліна Вероніка Анна Еней Ельдар,н о а а с с я я в а й а а а а й р,17,15~22,Output: н о а а с с я я в а й а а а а й р,373,352,21
Анісія Артем Барбара Ельдар Денис Мія Єфрем Стефанія Георгій Дмитро Олександра Рахіль Суламіта Естер Лука Веремій Суламіта Олександр Ярослав,я м а р с я м я й о а ь а р а й а р в,19,15~22,Output: я м а р с я м я й о а л а р й а р д в,391,368,23
Веремій Аделіна Стефанія Веремій Тиміш Ярослав Марк Ян Марк Мартін Олександр Олександра Нестор Тім Ярослав,й а я й ш в к н к н р а р м в,15,15~22,Output: й а я й ш в к н к н р а р м в,359,340,19
Марк Олівія Артем Олександра Анісія Есмі Алан Лео Дарина Агата Амір Еліс Ангеліна Мілана Вікторія Анісія Анастасія Сарра,к я м а я і н о а а р с а а я я я а,18,15~22,Output: к а м а я і н о а а р с а а я я а я а,381,360,21
Назар Рахіль Олександра Захар Аделіна Олександра Тім Тімур Суламіта Міран Меланія Анна Арсен Еліс Ангеліна Наомі Емілія Христина Еліна Давид,р ь а р а а м р а н я а н с а і я а а д,20,15~22,Output: р л а р а а м р а н я а н с а а і я а а д,388,365,23
Сінан Дмитро Давид Тім Дмитро Алан Самуїл Сінан Ангеліна Єфрем Арсен Гордій Єремія Алан Дарина,н о д м о н л н а м н й я н а,15,15~22,Output: н о д м о н л н а м н й я н а,360,342,18
Тальха Суламіта Роман Алім Олівія Лео Максим Олівія Стефанія Уляна Ілай Макар Аскольд Тиміш Соломія Матвій Максим,а а н м я о м я я а й р д ш я й м,17,15~22,Output: а а н м я о м я я а й р д ш я й м,373,352,21
Сарра Даниїл Меланія Веремій Ян Олександра Заріна Магдалина Лея Орися Ярема Яків Матвій Ярема Яна Аскольд Аліна,а л я й н а а а я я а в й а а д а,17,15~22,Output: а л я й н а а а я я а в й а а д а,372,351,21
Ангеліна Алім Христина Емма Рувим Леонард Наомі Тальха Єва Гордій Сарра Гордій Анастасія Вікторія Соломія Самуїл Діана Рахіль Квітослава,а м а а м д і а а й а й я я я л а ь а,19,15~22,Output: а м а а м д і а а й а й я я я л а л а,393,370,23
Гордій Суламіта Розалія Тімур Анастасія Аделіна Вікторія Естер Леві Тальха Даниїл Тиміш Денис Злата Ян Аріна Лєтті Данило Тиміш,й а я р я а я р і а л ш с а н а і о ш,19,15~22,Output: й а я р я а я р і а л ш с а н а і о ш,384,362,22
Ярина Яна Єва Міран Сінан Магдалина Матвій Олександра Яків Анелія Анастасія Агата Лука Аделіна Назар Вікторія,а а а н н а й а в я я а а а р я,16,15~22,Output: а а а н н а й а в я я а а а р я,366,347,19
Тімур Мартін Магдалина Тадей Лео Суламіта Ярослав Есфір Макар Ельдар Даяна Емілія Єфрем Орися Дмитро Тіна Яків Орися Ілай Анна Ангеліна,р н а й о а в р р р а я м я о а в я й а а,21,15~22,Output: р н а й о а в р а р а я м я о а в я й а а,393,368,25
Єремія Андрій Тімур Христина Богдан Самуїл Андрій Ангеліна Вероніка Магдалина Максим Олівія Суламіта Яків Еліс Заріна Анісія Наомі,я й р а н л й а а а м я а в с а я і,18,15~22,Output: я й р а н л й а а а м я а в с а я я і,390,367,23
Давид Даяна Мартін Ілай Анна Агата Артем Дмитро Діана Веремій Єлизавета Барбара Аріна Таїсія Алім Захар,д а н й а а м о а й а а а я м р,16,15~22,Output: д а н й а а м о а й а а а я м р,368,348,20
Даниїл Лука Тиміш Аделіна Гордій Аріна Левій Єлизавета Дмитро Амір Тимофій Заріна Емма Даяна Есмі Яна Лука Суламіта Анелія Матвій Емілія,л а ш а й а й а о р й а а а і а а а я й я,21,15~22,Output: л а ш а й а й а о р й а а а і я а а я й я,402,375,27
Мартін Мія Квітослава Дарина Аліна Аскольд Христина Ярослав Леві Рамазан Єремія Есмі Ілай Лука Авенір Данило Орися Андрій Еріка Аліна Давид,н я а а а д а в і н я і й а р о я й а а д,21,15~22,Output: н я а а а д а в і н я і й а р о я й а а д,391,366,25
Олександра Христина Владислав Олександра Еней Орися Леонард Олександр Назар Олександр Тім Макар Георгій Емма Олександр Веремій Веремій Тиміш,а а в а й я д р р р м р й а р й й ш,18,15~22,Output: а а в а й я д р а р ій а й а р й ш,381,358,23
Даниїл Наомі Агата Олександра Еліна Христина Єва Еріка Стефанія Уляна Есмі Леонард Самуїл Анелія Аріна Матвій Магдалина Нестор Дмитро Анна,л і а а а а а а я а і д л я а й а р о а,20,15~22,Output: л і а а а а а я а і д л я а й а р о а,389,367,22
Есмі Павло Алан Захар Алан Назар Аделіна Рувим Яків Лео Розалія Авенір Мілана Соломія Емілія,і о н р н р а м в о я р а я я,15,15~22,Output: і о н р н р а м в о я р а я я,359,342,17
Міран Дарина Софія Аріна Олександр Ангеліна Дмитро Злата Левій Заріна Тадей Естер Аліна Дмитро Анастасія Тім Мія,н а я а р а о а й а й р а о я м я,17,15~22,Output: н а я а р а о а й а й р а о я м я,370,349,21
Наомі Орися Самуїл Ярина Квітослава Яків Марк Павло Лея Макар Авенір Богдан Яків Даниїл Олександра,і я л а а в к о я р р н в л а,15,15~22,Output: і я л а а в к о я р р н в л а,363,346,17
Еліс Міран Сарра Стефанія Нестор Лео Назар Георгій Владислав Стефанія Агата Есфір Павло Денис Владислав Рахіль,с н а я р о р й в я а р о с в ь,16,15~22,Output: с н а я р о р й в а а р о с в л ь,365,344,21
Сінан Аліна Міран Леонард Вероніка Діана Есмі Леонард Лукас Злата Леві Леонард Есфір Анісія Анна Ярослав,н а н д а а і д с а і д р я а в,16,15~22,Output: н а н д а а і д с а і д р я а в,369,351,18
Мілана Еней Даниїл Тиміш Яків Павло Сарра Тіна Северин Ян Владислав Рувим Лео Алім Ельдар Ілай Тальха Рахіль Ярослав Гордій Олівія,а й л ш в о а а н н в м о м р й а ь в й я,21,15~22,Output: а й л ш в о а а н н в м о м р й а а л в й я,392,365,27
Тимофій Естер Тадей Рахіль Вікторія Соломія Артем Авенір Ілай Еріка Еліс Андрій Есфір Самуїл Артем Тім Лєтті Естер Орися Анісія,й р й ь я я м р й а с й р л м м і р я я,20,15~22,Output: й р й л я я м р й а с й р л м м т і р я я,398,371,27
Ярослав Даяна Дмитро Мартін Лея Анна Еней Софія Самуїл Тиміш Тім Тиміш Яків Денис Аделіна Єва,в а о н я а й я л ш м ш в с а а,16,15~22,Output: в а о н я а й я л ш м ш в с а а,361,342,19
Веремій Ярослав Даяна Лукас Естер Алан Алан Соломія Рамазан Лукас Самуїл Анна Захар Дмитро Анна Данило,й в а с р н н я н с л а р о а о,16,15~22,Output: й в а с р н н я н с л а а р о а о,363,343,20
Лея Аскольд Есфір Авенір Наомі Анісія Лея Тиміш Назар Розалія Єремія Денис Левій Тиміш Христина Соломія,я д р р і я я ш р я я с й ш а я,16,15~22,Output: я д р р і я я ш р я с й ш а я,368,350,18
Ангеліна Денис Леві Леві Емма Рувим Олександра Амір Георгій Даяна Сінан Квітослава Дмитро Рахіль Таїсія,а с і і а м а р й а н а о ь я,15,15~22,Output: а с і і а м а р й а н а о л я,367,349,18
Анісія Єфрем Єфрем Давид Дмитро Лео Естер Анна Лео Тимофій Леві Назар Павло Захар Максим,я м м д о о р а о й і р о р м,15,15~22,Output: я м м д о о р а о й і р о р м,356,338,18
Софія Аделіна Богдан Аскольд Аскольд Назар Олександр Матвій Розалія Артем Суламіта Есфір Еріка Заріна Нестор Олівія Ярина Єфрем Ілай,я а н д д р р й я м а р а а р я а м й,19,15~22,Output: я а н д д р р й я м р а а р о я а м й,385,362,23
Есфір Роман Таїсія Даниїл Емілія Ярина Алан Уляна Давид Давид Амір Леві Естер Георгій Олександра Діана Анна,р н я л я а н а д д р і р й а а а,17,15~22,Output: р н я л я а н а д д р і р й а а а,370,350,20
Асаф Авенір Рамазан Єва Мілана Матвій Стефанія Мартін Тальха Стефанія Мартін Назар Ілай Есмі Есмі Северин,ф р н а а й я н а я н р й і і н,16,15~22,Output: ф р н а а й я н а я н р й і і н,368,348,20
Софія Ілай Рамазан Квітослава Авенір Ярослав Таїсія Анелія Христина Мілана Захар Олександр Рахіль Тимофій Лєтті Дмитро Мартін Аріна,я й н а р в я я а а р р ь й і о н а,18,15~22,Output: я й н а р в я я а а р р л й і о н а,392,370,22
Левій Вікторія Софія Тиміш Магдалина Олександра Гордій Ян Лєтті Есфір Барбара Суламіта Анастасія Анна Матвій Давид,й я я ш а а й н і р а а я а й д,16,15~22,Output: й я я ш а а й н і р а а я а й д,378,357,21
Єфрем Агата Дарина Леонард Ярина Наомі Аделіна Есфір Леві Мія Марк Тальха Естер Рамазан Максим,м а а д а і а р і я к а р н м,15,15~22,Output: м а а д а і а р і я к а р н м,353,336,17
Авенір Лео Марк Марк Еліс Орися Аскольд Левій Асаф Ярослав Уляна Міран Емма Яків Вероніка Есмі Аріна Єфрем,р о к к с я д й ф в а н а в а і а м,18,15~22,Output: р о к к с я д й ф в а н а в а і а м,371,350,21
Тімур Міран Анна Аскольд Лука Веремій Данило Ян Арсен Вероніка Тім Даяна Богдан Есфір Магдалина,р н а д а й о н н а м а н р а,15,15~22,Output: р н а д а й о н н м а н а р а,355,337,18
Дарина Еріка Еліна Ярослав Тимофій Матвій Лука Даяна Софія Ян Вероніка Меланія Міран Суламіта Самуїл Сінан Леві Барбара,а а а в й й а а я н а я н а л н і а,18,15~22,Output: а а а в й й а а я н а я н а л а й а,381,358,23
Лео Сінан Вікторія Аскольд Олександра Лео Марк Анелія Амір Соломія Меланія Еліс Тимофій Нестор Анелія Вікторія Ангеліна Тимофій Міран Матвій Лука,о н я д а о к я р я я с й р я я а й н й а,21,15~22,Output: о н я д а о к я р я я с й р я я а й н й а,402,376,26
Алан Заріна Олександра Сінан Вікторія Амір Діана Еліс Асаф Рахіль Христина Діана Богдан Єремія Леонард Аскольд Арсен,н а а н я р а с ф ь а а н я д д н,17,15~22,Output: н а а н я р а с ф л а а н я д д н,373,354,19
Софія Ярема Марк Богдан Аліна Алан Лєтті Леві Мія Соломія Аскольд Владислав Таїсія Амір Орися Емма Тадей Ангеліна Ярина,я а к н а н і і я я д в я р я а й а а,19,15~22,Output: я а к н а н і і я я д в я р я а й а а,382,360,22
Даниїл Христина Веремій Єфрем Заріна Єва Рамазан Роман Аріна Ангеліна Тимофій Гордій Тадей Сінан Ярослав Есфір Есмі,л а й м а а н н а а й й й н в р і,17,15~22,Output: л а й м а а н н а а й й й н в р і,376,353,23
Мілана Мартін Макар Рахіль Мія Тимофій Заріна Еліс Суламіта Алан Ян Самуїл Захар Яків Христина Нестор Єремія Анастасія Мілана Орися Анна,а н р ь я й а с а н н л р в а р я я а я а,21,15~22,Output: а н р л я й а с а н н л р в а р я я а я а,395,371,24
Владислав Леонард Назар Ярина Христина Суламіта Еріка Еней Андрій Орися Ярослав Тімур Лея Єремія Данило Роман Павло Есфір Денис Есмі Яків,в д р а а а а й й я в р я я о н о р с і в,21,15~22,Output: в д р а а а а й я я в р я о н о о р с с і в,391,366,25
Максим Максим Емілія Алан Еней Ян Есмі Тимофій Максим Самуїл Діана Алан Левій Макар Аріна,м м я н й н і й м л а н й р а,15,15~22,Output: м м я н й н і й м л а н й р а,358,338,20
Мілана Єфрем Діана Леві Єфрем Аріна Ярослав Орися Асаф Денис Тадей Матвій Марк Анелія Вероніка Софія,а м а і м а в я ф с й й к я а я,16,15~22,Output: а м а і м а в я ф с й й к я а я,365,345,20
Анісія Орися Єва Олівія Алан Артем Сінан Мартін Меланія Захар Алім Еріка Тадей Магдалина Лєтті Рамазан Заріна,я я а я н м н н я р м а й а і н а,17,15~22,Output: я я а я н м н я р м а а й а і н а,373,353,20
Рамазан Захар Естер Марк Суламіта Алім Рамазан Арсен Еліна Захар Барбара Олександр Розалія Ельдар Северин Захар Естер Таїсія Данило,н р р к а м н н а р а р я р н р р я о,19,15~22,Output: н р р к а м н н а р а р я р н р я о,379,359,20
Анастасія Андрій Олександра Олександр Естер Андрій Рахіль Андрій Ельдар Дарина Тадей Даяна Ярослав Вікторія Христина Мія Софія Софія Аріна,я й а р р й ь й р а й а в я а я я я а,19,15~22,Output: я й а р р й л й р а й а в я а я я а а,388,363,25
Анастасія Аліна Рувим Ярема Анелія Сарра Лея Леонард Аріна Макар Анна Вероніка Яна Лєтті Аріна Анна Артем,я а м а я а я д а р а а а і а а м,17,15~22,Output: я а м а я а я д а р а а а і а а м,370,351,19
Аліна Алім Сарра Аскольд Рамазан Аскольд Лєтті Аскольд Ярема Макар Ярослав Анелія Естер Марк Стефанія Гордій Олександр Христина Богдан Дмитро,а м а д н д і д а р в я р к я й р а н о,20,15~22,Output: а м а д н д і д а р в я р к я й р а н о,388,365,23
Квітослава Павло Лука Міран Самуїл Аделіна Асаф Лео Самуїл Тадей Олександр Захар Еріка Вероніка Андрій Денис Стефанія,а о а н л а ф о л й р р а а й с я,17,15~22,Output: а о а н л а ф о л й р а а а й с я,376,355,21
Анастасія Таїсія Гордій Дмитро Агата Есмі Олександра Мілана Павло Тиміш Дарина Амір Олександр Анісія Діана Естер Рамазан Еней Ангеліна Ілай Вероніка,я я й о а і а а о ш а р р я а р н й а й а,21,15~22,Output: я я й о а і а а о ш а р д я а р а й а й а,399,373,26
Єва Уляна Орися Андрій Тимофій Наомі Лея Самуїл Тальха Еліс Наомі Анісія Лука Анна Даниїл Яків Тадей Анна Лея Северин,а а я й й і я л а с і я а а л в й а я н,20,15~22,Output: а а я й й і я л а с і я а а л в й а я н,388,363,25
Аделіна Мілана Владислав Тадей Христина Данило Єва Асаф Леві Суламіта Еней Мартін Владислав Тіна Нестор Левій Агата Алан Олександра Максим,а а в й а о а ф і а й н в а р й а н а м,20,15~22,Output: а а в й а о а ф і а й н в а р й а н а м,381,356,25
Давид Анелія Лука Леонард Ангеліна Тиміш Єремія Анісія Лея Анастасія Рамазан Єва Данило Левій Орися Анна Тімур,д я а д а ш я я я я н а о й я а р,17,15~22,Output: д я а д а ш я я я я н а о й я а р,374,354,20
Христина Тіна Ельдар Павло Емілія Захар Дарина Арсен Ілай Емілія Олівія Дарина Артем Леонард Сарра,а а р о я р а н й я я а м д а,15,15~22,Output: а а р о я р а й я я а м д а р,361,343,18
Рувим Захар Тальха Богдан Еней Назар Злата Уляна Богдан Дарина Ярослав Аделіна Лука Роман Наомі Анастасія Барбара Нестор Вікторія,м р а н й р а а н а в а а н і я а р я,19,15~22,Output: м р а н й р а а н а в а а н і я а р я,375,353,22
Алан Сарра Мілана Христина Левій Лука Діана Магдалина Нестор Макар Тиміш Веремій Єремія Дмитро Емма Ельдар,н а а а й а а а р р ш й я о а р,16,15~22,Output: н а а а й а а а р р ш й я о а р,365,345,20
Агата Христина Аделіна Єлизавета Єфрем Давид Артем Лєтті Суламіта Мілана Северин Левій Тімур Ярина Леві Захар Софія Даяна,а а а а м д м і а а н й р а і р я а,18,15~22,Output: а а а а м д м а а а н й р а й р я а,382,360,22
Ілай Назар Мартін Естер Стефанія Єлизавета Емма Аделіна Анастасія Сарра Лука Лукас Захар Дмитро Барбара Лєтті Сінан Сарра Сінан,й р н р я а а а я а а с р о а і н а н,19,15~22,Output: й р н р я а а а я а а с р о а і н а н,385,363,22
Суламіта Міран Артем Ярема Роман Єва Даяна Олівія Леонард Софія Магдалина Лука Сарра Емма Агата Алім Матвій Ярема Еліс Тимофій Леонард,а н м а н а а я д я а а а а а м й а с й д,21,15~22,Output: а н м а н а а я я а а а а а а м й а с й д,394,369,25
Тадей Вікторія Софія Барбара Еліс Денис Еней Мія Тіна Ангеліна Рамазан Еріка Дмитро Владислав Нестор Орися Владислав Тальха Олександр,й я я а с с й я а а н а о в р я в а р,19,15~22,Output: й я я а с с й я а а н а о в р я в а р,380,357,23
Яна Роман Емма Ангеліна Аріна Асаф Авенір Меланія Ярема Матвій Ангеліна Ярослав Захар Георгій Анісія,а н а а а ф р я а й а в р й я,15,15~22,Output: а н а а а ф р я а й а в р й я,366,347,19
Таїсія Аскольд Захар Емілія Владислав Павло Ярослав Яна Квітослава Мартін Лукас Олександра Мартін Данило Злата,я д р я в о в а а н с а н о а,15,15~22,Output: я д р я в о в а н с а н о а,361,345,16
Павло Рахіль Сарра Аделіна Асаф Даяна Аделіна Стефанія Єфрем Тіна Рахіль Олександр Авенір Сарра Барбара Нестор Емма Самуїл Дмитро Емма,о ь а а ф а а я м а ь р р а а р а л о а,20,15~22,Output: о л а а ф а а я м а л р р а р о а л о а,383,361,22
Нестор Яна Ярослав Аделіна Мія Павло Алан Рамазан Самуїл Захар Вероніка Дмитро Злата Тімур Тиміш Северин Аріна Максим,р а в а я о н н л р а о а р ш н а м,18,15~22,Output: р а в а я о н н л р а о а р ш н а м,368,348,20
Олівія Северин Наомі Веремій Северин Лео Ангеліна Ярина Барбара Тальха Розалія Лукас Дарина Мілана Авенір Леві Мартін Лео Дарина Яків Даяна,я н і й н о а а а а я с а а р і н о а в а,21,15~22,Output: я н і й н о а а а а с а а а р і н о а в а,395,371,24
Тімур Анісія Еліс Заріна Лукас Максим Данило Тіна Стефанія Алім Богдан Тальха Барбара Єлизавета Леві Тіна Тимофій Вікторія,р я с а с м о а я м н а а а і а й я,18,15~22,Output: р я с а с м о а я м н а а а і а й я,381,360,21
Нестор Уляна Рахіль Анелія Еліна Ангеліна Авенір Суламіта Єремія Алім Олександр Богдан Єфрем Лукас Веремій Северин Анастасія,р а ь я а а р а я м р н м с й н я,17,15~22,Output: р а л я а а р а я м р н м с й н я,378,358,20
Мілана Тіна Уляна Северин Тіна Матвій Тімур Анастасія Вероніка Агата Матвій Лєтті Северин Квітослава Нестор Суламіта Ілай Есфір Аделіна,а а а н а й р я а а й і н а р а й р а,19,15~22,Output: а а а н а й р я а й і н а р а а р іна,388,365,23
Максим Еліс Тимофій Алан Даяна Роман Яків Веремій Рахіль Орися Яна Емілія Леві Анелія Магдалина Владислав Давид Тальха Еней Лео,м с й н а н в й ь я а я і я а в д а й о,20,15~22,Output: м с й н а н в й л я а я в я а в д а й о,386,361,25
Діана Розалія Міран Павло Лео Ярина Рахіль Рувим Еріка Магдалина Злата Суламіта Злата Андрій Тимофій Андрій Алім Тимофій,а я н о о а ь м а а а а а й й й м й,18,15~22,Output: а я н о о а л м а а а а а й й й м й,382,358,24
Ян Аскольд Леві Леонард Макар Єремія Тадей Еліна Вікторія Квітослава Рувим Леві Єва Суламіта Мілана Рахіль Гордій Денис Агата Ельдар Міран,н д і д р я й а я а м і а а а ь й с а р н,21,15~22,Output: н д і д р я й а я а м і а а а л й с а р а,394,369,25
Софія Злата Богдан Яків,я а н в,4,1~8,Output: я а н в,302,296,6
Алан Рамазан Нестор Яна Лука Самуїл,н н р а а л,6,1~8,Output: н н р а а л,310,302,8
Барбара Алан Лука Сінан Яків Софія Діана,а н а н в я а,7,1~8,Output: а н а н в я а,318,309,9
Ярина Тіна Авенір Тіна Алан Нестор,а а р а н р,6,1~8,Output: а а р а н р,308,300,8
Тиміш Роман Суламіта Матвій Квітослава Гордій Еріка,ш н а й а й а,7,1~8,Output: ш н а й а й а,324,313,11
Ілай Ельдар Аріна Соломія,й р а я,4,1~8,Output: й р а я,303,296,7
Рахіль Асаф Мартін Соломія,ь ф н я,4,1~8,Output: л ф н я,303,297,6
Леві Назар Тимофій Софія Мія,і р й я я,5,1~8,Output: і р й я я,308,300,8
Міран Вероніка Емма,н а а,3,1~8,Output: н а а,295,290,5
Дмитро Аскольд Еліс Алан Лукас Стефанія,о д с н с я,6,1~8,Output: о д с н с я,314,306,8
Ельдар Денис Софія Єва Лукас Ярина,р с я а с а,6,1~8,Output: р с я а с а,311,303,8
Олександр Максим Софія Анісія Діана Тальха,р м я я а а,6,1~8,Output: р м я я а а,314,306,8
Макар Єремія Левій,р я й,3,1~8,Output: р я й,298,292,6
Єремія Леві Меланія,я і я,3,1~8,Output: я і я,298,293,5
Северин Марк Заріна Лео Дарина,н к а о а,5,1~8,Output: н к а о а,304,297,7
Артем Давид Тіна Яків Сінан Анастасія Есфір,м д а в н я р,7,1~8,Output: м д а в н я р,318,309,9
Суламіта Христина Лукас Тімур,а а с р,4,1~8,Output: а а с р,305,299,6
Мартін Ілай Ярема Аріна Барбара,н й а а а,5,1~8,Output: н й а а а,308,300,8
Вероніка Орися Діана Гордій Лєтті,а я а й і,5,1~8,Output: а я а й і,312,304,8
Тадей Соломія Наомі Веремій Захар,й я і й р,5,1~8,Output: й я і й р,309,300,9
Уляна Орися Сінан Тім Рахіль Аскольд Богдан,а я н м ь д н,7,1~8,Output: а я н м л д н,315,306,9
Олександр Тадей Андрій,р й й,3,1~8,Output: р й й,299,292,7
Соломія Асаф Лука,я ф а,3,1~8,Output: я ф а,297,292,5
Барбара Заріна Назар Квітослава Ілай Роман Ярослав,а а р а й н в,7,1~8,Output: а а р а й н в,319,309,10
Лука Лукас,а с,2,1~8,Output: а с,292,288,4
Гордій Вероніка Ярослав Дмитро Стефанія,й а в о я,5,1~8,Output: й а в о я,312,304,8
Лука Северин Ян Олександра Рувим Єфрем Давид,а н н а м м д,7,1~8,Output: а н н а м м д,315,306,9
Северин Олександр,н р,2,1~8,Output: н р,292,288,4
Амір Веремій Дмитро,р й о,3,1~8,Output: р й о,299,293,6
Тимофій Данило Яна,й о а,3,1~8,Output: й о а,297,291,6
Алім Ян Соломія Сарра,м н я а,4,1~8,Output: м н я а,300,294,6
Северин Андрій,н й,2,1~8,Output: н й,293,288,5
Денис Лео Уляна Вероніка,с о а а,4,1~8,Output: с о а а,300,294,6
Єва Єва Злата Олександра Рамазан,а а а а н,5,1~8,Output: а а а а н,304,297,7
Матвій Асаф,й ф,2,1~8,Output: й ф,293,288,5
Мілана Тиміш Северин Захар Вероніка,а ш н р а,5,1~8,Output: а ш н р а,308,301,7
Артем Сарра Уляна Розалія Матвій Аскольд Заріна,м а а я й д а,7,1~8,Output: м а а я й д а,317,307,10
Меланія Леві,я і,2,1~8,Output: я й,293,288,5
Есмі Владислав Лука Тимофій Еней Гордій,і в а й й й,6,1~8,Output: і в а й й й,316,305,11
Лукас Вероніка Квітослава Давид Максим Мартін Асаф,с а а д м н ф,7,1~8,Output: с а а д м н ф,319,310,9
Меланія Денис Анастасія Владислав,я с я в,4,1~8,Output: я с я в,303,297,6
Міран Есмі,н і,2,1~8,Output: н і,290,286,4
Ельдар Меланія Барбара Лео,р я а о,4,1~8,Output: р я а о,303,297,6
Максим Ярослав Георгій Мілана Анелія,м в й а я,5,1~8,Output: м в й а я,310,302,8
Лукас Арсен Рамазан Владислав Емма,с н н в а,5,1~8,Output: с н н в а,306,299,7
Квітослава Лукас Мілана Нестор,а с а р,4,1~8,Output: а с а р,305,299,6
Лео Єфрем Яна Яна Северин,о м а а н,5,1~8,Output: о м а а н,304,297,7
Розалія Дарина Вікторія Естер Тальха,я а я р а,5,1~8,Output: я а я р а,307,300,7
Анастасія Єва Дмитро Дмитро,я а о о,4,1~8,Output: я а о о,304,298,6
Сарра Рувим Ярина Георгій,а м а й,4,1~8,Output: а м а й,303,296,7
Яків Захар Заріна,в р а,3,1~8,Output: в р а,297,292,5
Мія Тимофій,я й,2,1~8,Output: я й,293,288,5
Суламіта Лука Амір Олівія Матвій Аскольд Леві,а а р я й д і,7,1~8,Output: а а р я й д і,322,312,10
Есмі Діана Анастасія Рахіль,і а я ь,4,1~8,Output: і а я л,304,298,6
Еріка Тальха Єлизавета Леві,а а а і,4,1~8,Output: а а а і,304,298,6
Квітослава Владислав Аскольд,а в д,3,1~8,Output: а в д,299,294,5
Алім Назар Магдалина Асаф Софія Дарина,м р а ф я а,6,1~8,Output: м р а ф я а,311,303,8
Сарра Веремій Квітослава Амір Єлизавета Меланія Розалія,а й а р а я я,7,1~8,Output: а й а р а я я,325,315,10
Нестор Розалія,р я,2,1~8,Output: р я,291,287,4
Лука Сарра Тімур Квітослава Анелія,а а р а я,5,1~8,Output: а а р а я,309,302,7
Ян Яків Тальха Дмитро Стефанія Міран Наомі,н в а о я н і,7,1~8,Output: н в а о я н і,318,309,9
Наомі Тім Гордій Лео Леонард Тадей Тальха,і м й о д й а,7,1~8,Output: і м й о д й а,319,308,11
Анна Владислав Анастасія Яків Меланія Роман,а в я в я н,6,1~8,Output: а в я в я н,313,305,8
Ярослав Тімур Наомі Олександр,в р і р,4,1~8,Output: в р і р,302,296,6
Дарина Єва Сарра Аделіна,а а а а,4,1~8,Output: а а а а,298,292,6
Розалія Еліна Тальха Леві Сінан Єва Владислав,я а а і н а в,7,1~8,Output: я а а і н а в,316,307,9
Есмі Владислав,і в,2,1~8,Output: і в,291,287,4
Сінан Авенір Амір Заріна Ярина Ярина Ярослав,н р р а а а в,7,1~8,Output: н р р а а а в,317,308,9
Даяна Марк Алім Сарра,а к м а,4,1~8,Output: а к м а,298,292,6
Анісія Ангеліна Аделіна,я а а,3,1~8,Output: я а а,300,295,5
Єфрем Діана Макар Роман Дмитро Лео Асаф,м а р н о о ф,7,1~8,Output: м а р н о о ф,315,306,9
Артем Вероніка Еліс Еліна Владислав Ярина,м а с а в а,6,1~8,Output: м а с а в а,312,304,8
Тимофій Соломія Анастасія Христина Аліна Павло,й я я а а о,6,1~8,Output: й я я а а о,317,308,9
Даниїл Сарра Амір Тальха,л а р а,4,1~8,Output: л а р а,301,295,6
Меланія Ярослав,я в,2,1~8,Output: я в,292,288,4
Арсен Заріна Агата Олександра Естер Лео Уляна Естер Владислав Леонард Владислав Нестор Вероніка Єфрем Еліс Емілія Тадей Єфрем Марк Тиміш Таїсія Лео Денис,н а а а р о а р в д в р а м с я й м к ш я о с,23,22~30,Output: н а а а р о а р в д в р а м с я й м к ш я о с,398,372,26
Даниїл Амір Стефанія Леві Максим Барбара Заріна Еней Яків Есмі Олівія Діана Єремія Софія Ярема Павло Сарра Ян Анна Есмі Рахіль Наомі Злата Таїсія Вероніка,л р я і м а а й в і я а я я а о а н а і ь і а я а,25,22~30,Output: л р я і м а а й в і я а я я а о а н а а і л і а я а,415,386,29
Георгій Лукас Данило Заріна Мілана Лея Гордій Аріна Матвій Дарина Заріна Амір Діана Лєтті Єремія Артем Георгій Роман Тімур Ярослав Аделіна Тім,й с о а а я й а й а а р а і я м й н р в а м,22,22~30,Output: й с о а а я й а й а а р а і я м й н р в а м,403,375,28
Розалія Рахіль Матвій Яків Данило Мія Розалія Софія Емма Нестор Данило Лео Северин Самуїл Ілай Барбара Алім Магдалина Лукас Веремій Сарра Роман Гордій Єремія,я ь й в о я я я а р о о н л й а м а с й а н й я,24,22~30,Output: я л й в о я я а о л о о н л й а м а с й а а н й я,413,382,31
Максим Єва Естер Лея Софія Ельдар Аріна Барбара Ярослав Богдан Аріна Тиміш Есмі Ельдар Арсен Мартін Назар Вікторія Артем Авенір Ярослав Квітослава Олександра Еліс Амір Данило Олександра Даяна,м а р я я р а а в н а ш і р н н р я м р в а а с р о а а,28,22~30,Output: м а р я я р а а в н а ш і р н ін н я м р в а а а с а р о а а а,429,395,34
Лєтті Андрій Арсен Макар Рахіль Роман Стефанія Аліна Есмі Соломія Ярина Олександр Лео Еліс Яна Агата Еней Максим Алім Естер Міран Ярема Орися Есмі Соломія Анастасія Самуїл,і й н р ь н я а і я а р о с а а й м м р н а я і я я л,27,22~30,Output: і й н р л н я а і я а р о с а а й м м р а а я я і я л,424,393,31
Яна Агата Захар Ярема Георгій Даниїл Еліс Лука Данило Вікторія Северин Магдалина Заріна Лєтті Заріна Георгій Тімур Георгій Олівія Таїсія Міран Андрій Лео Андрій Максим,а а р а й л с а о я н а а і а й р й я я н й о й м,25,22~30,Output: а а р а й л с а о я а а а й а й р й я я н й о й м,427,394,33
Ярина Георгій Ілай Вікторія Тадей Сарра Гордій Денис Амір Нестор Сарра Авенір Рувим Самуїл Алан Квітослава Естер Тимофій Вікторія Алан Максим Ярина Емілія Єфрем Мія Вероніка Рахіль Владислав,а й й я й а й с р р а р м л н а р й я н м а я м я а ь в,28,22~30,Output: а й й я й а й с р о а р м л н а р й я н м а а я я а а л,435,400,35
Емілія Леві Еліна Ян Яків Єфрем Ян Лея Веремій Тіна Емма Сарра Владислав Аліна Злата Мартін Агата Анісія Ян Вероніка Анелія Авенір Стефанія Тімур Марк Христина Тадей Лєтті,я і а н в м н я й а а а в а а н а я н а я р я р к а й і,28,22~30,Output: я і а н в м н а й а а а в а а н а я н а р я у р к а й і,428,396,32
Самуїл Максим Софія Алан Таїсія Яків Андрій Суламіта Рувим Олександр Владислав Єремія Діана Соломія Орися Лукас Тадей Еліс Алім Анелія Роман Мія Лука Аделіна,л м я н я в й а м р в я а я я с й с м я н я а а,24,22~30,Output: л м я н я в й а м р в я а я я с й с м я н я а а,413,385,28
Еліс Наомі Еріка Ян Ангеліна Христина Тадей Гордій Рахіль Амір Даяна Марк Емілія Уляна Аделіна Есфір Олександр Яків Стефанія Міран Владислав Даяна Данило Анна Георгій Дмитро Лея Ян,с і а н а а й й ь р а к я а а р р в я н в а о а й о я н,28,22~30,Output: с і а н а а й й л р а а к я а а р р в н я н в а о а й о я н,431,396,35
Леві Асаф Тиміш Ярина Анастасія Самуїл Лєтті Аріна Емілія Єлизавета Суламіта Северин Соломія Ян Єфрем Георгій Тиміш Тиміш Лєтті Амір Леві Марк Дмитро Вікторія Єлизавета Соломія Сінан,і ф ш а я л і а я а а н я н м й ш ш і р і к о я а я н,27,22~30,Output: і ф ш а я л і а я а і я н м й ш ш і р і к о я а я н,441,412,29
Ангеліна Еней Аскольд Леонард Наомі Олександр Олівія Еріка Назар Арсен Естер Рувим Аліна Єремія Тадей Авенір Уляна Олександра Тимофій Єлизавета Квітослава Павло Єва,а й д д і р я а р н р м а я й р а а й а а о а,23,22~30,Output: а й д д і р я а р н р м а я й р а а й а а о а ло,412,382,30
Естер Матвій Дарина Анісія Максим Емма Мілана Розалія Наомі Міран Ярослав Ярема Аліна Олександр Анелія Лея Анна Мілана Артем Меланія Розалія Наомі Барбара Анелія,р й а я м а а я і н в а а р я я а а м я я і а я,24,22~30,Output: р й а я м а а я і н в а а р я я а а м я я і а я,408,381,27
Есфір Лєтті Данило Олександра Мілана Розалія Еней Ілай Еліс Дмитро Еліна Еліна Наомі Олександр Софія Лєтті Даниїл Денис Северин Макар Орися Рувим Діана Яків Ангеліна,р і о а а я й й с о а а і р я і л с н р я м а в а,25,22~30,Output: р і о а а я й с о а а і р я і л с н р а я м а в іна,421,392,29
Назар Левій Ярина Алан Аделіна Олександра Естер Самуїл Софія Мілана Аскольд Наомі Орися Рамазан Северин Георгій Уляна Амір Тім Ярема Розалія Тиміш Тіна Емілія Богдан Тіна Анелія Мартін,р й а н а а р л я а д і я н н й а р м а я ш а я н а я н,28,22~30,Output: р й а н а а р л я а д і я н н й а р м а я ш а я н а я н,428,396,32
Ярема Таїсія Тимофій Рамазан Артем Аліна Есфір Даяна Христина Веремій Анастасія Тім Олександра Северин Мія Яків Георгій Тимофій Арсен Марк Софія Анастасія Захар Алан Мія Єва,а я й н м а р а а й я м а н я в й й н к я я р н я а,26,22~30,Output: а я й н м а р а а а й я м а н я в й й н к я я р н я а,428,395,33
Авенір Яків Емма Матвій Захар Емілія Естер Суламіта Естер Арсен Міран Анна Тальха Леонард Анісія Розалія Єремія Гордій Лея Леонард Олександра Самуїл Аліна Есмі Денис Ян Захар,р в а й р я р а р н н а а д я я я й я д а л а і с н р,27,22~30,Output: р в а й р я р а р н а а а д я я я й я д а л а а і с н а р,432,399,33
Авенір Тальха Тімур Макар Даниїл Єва Стефанія Ангеліна Софія Христина Аскольд Алан Максим Квітослава Ярина Тальха Еріка Даяна Анелія Сарра Олександр Ярема Єлизавета Веремій Міран Давид Тіна Леонард Мартін,р а р р л а я а я а д н м а а а а а я а р а а й н д а д н,29,22~30,Output: р а р л л а я а я а д н м а а а а а я а р а а а а д а а д н,437,405,32
Ярина Яків Єлизавета Роман Магдалина Христина Розалія Павло Марк Аріна Марк Макар Рамазан Владислав Дарина Леві Аделіна Лео Лука Рахіль Анісія Артем,а в а н а а я о к а к р н в а і а о а ь я м,22,22~30,Output: а в а н а а я о к а к р н в а й а о а л ь я м,398,371,27
Гордій Соломія Стефанія Емілія Еней Анастасія Анісія Ярослав Денис Рахіль Асаф Олександр Єфрем Еліна Ангеліна Гордій Павло Павло Єлизавета Мілана Єфрем Еней Алан,й я я я й я я в с ь ф р м а а й о о а а м й н,23,22~30,Output: й я я я й я я в с л ф р м а а й о о а а м й н,413,384,29
Еріка Еліна Алан Таїсія Емма Таїсія Амір Сарра Ярина Олівія Назар Злата Авенір Христина Авенір Владислав Сінан Олександр Діана Нестор Денис Леві Таїсія Уляна Андрій Роман Орися Анна Амір,а а н я а я р а а я р а р а р в н р а р с і я а й н я а р,29,22~30,Output: а а н я а я р а я а р а р а в а р р а р і я а й н я а р,432,401,31
Лео Ян Тімур Тімур Марк Діана Сінан Анелія Тадей Орися Арсен Тім Міран Анастасія Лея Назар Яків Мілана Леві Ілай Анісія Лєтті,о н р р к а н я й я н м н я я р в а і й я і,22,22~30,Output: о н р р к а н я й я н м н я я р в а й й я і,398,371,27
Роман Сарра Заріна Вікторія Богдан Анастасія Денис Даниїл Данило Анісія Рахіль Стефанія Леві Амір Діана Нестор Веремій Христина Павло Даниїл Лео Авенір Авенір Мартін Наомі Андрій Назар Владислав,н а а я н я с л о я ь я і р а р й а о л о р р н і й р в,28,22~30,Output: н а а я н я с л о я л я і р а р й а о л о р р н і й р в,432,400,32
Нестор Вікторія Тіна Тиміш Наомі Захар Мартін Розалія Алім Захар Артем Алім Соломія Лєтті Єремія Еней Сінан Андрій Анісія Нестор Владислав Ельдар Соломія Еліна Меланія Нестор Заріна Яків,р я а ш і р н я м р м м я і я й н й я р в р я а я р а в,28,22~30,Output: р я а ш і р н я м р м м я і я й н й я р в р я а я о а в,432,400,32
Алім Естер Еліс Еріка Леонард Олівія Ілай Арсен Нестор Давид Єва Діана Сінан Макар Еней Дарина Лео Ярина Вероніка Мія Анна Анна Лука Авенір Есмі Олівія Арсен Ілай Авенір,м р с а д я й н р д а а н р й а о а а я а а а р і я н й р,29,22~30,Output: м р с а д я й н р д а а н р й а о а а я а а а р і я н й р,428,394,34
Квітослава Тимофій Амір Еней Яна Тальха Таїсія Тиміш Павло Аделіна Вероніка Назар Емма Ангеліна Тальха Богдан Максим Єва Анастасія Агата Наомі Тимофій Веремій Вікторія Мія Єва Тім Павло,а й р й а а я ш о а а р а а а н м а я а і й й я я а м о,28,22~30,Output: а й р й а а я ш о а а р а а а н м а я а і й й я а а м а о,432,397,35
Суламіта Еліна Левій Роман Георгій Богдан Ангеліна Рувим Ангеліна Есмі Ярина Аскольд Єремія Северин Матвій Олександр Захар Левій Розалія Ангеліна Роман Еріка Єремія Рамазан Таїсія Рахіль Лея Олександр,а а й н й н а м а і а д я н й р р й я а н а я н я ь я р,28,22~30,Output: а а й н й н а м а і а д я н й р р а й я а н а я а а я а р,446,411,35
Рамазан Аріна Рахіль Роман Назар Ярина Богдан Олександра Максим Левій Софія Матвій Максим Алім Тадей Олександр Міран Данило Ельдар Леві Естер Павло Ярослав Суламіта,н а ь н р а н а м й я й м м й р н о р і р о в а,24,22~30,Output: н а л н р а н а м й я й м м й р а о р в е о в а,403,374,29
Єлизавета Вікторія Роман Аліна Еліс Тадей Ілай Сінан Лея Рахіль Анелія Тімур Барбара Дарина Єлизавета Злата Лука Макар Барбара Рахіль Анісія Агата,а я н а с й й н я ь я р а а а а а р а ь я а,22,22~30,Output: а я н а с й й я л я я а а а а а а р а а л я а а,404,376,28
Гордій Меланія Лея Андрій Тім Лукас Мілана Мія Даяна Дмитро Барбара Богдан Денис Ярослав Артем Есмі Данило Діана Мілана Назар Захар Лео Анастасія Авенір Сінан Тимофій Владислав,й я я й м с а я а о а н с в м і о а а р р о я р н й в,27,22~30,Output: й я а й м с а я а о а н с в м і о а а р а о я р н й в,426,394,32
Арсен Лука Даяна Артем Георгій Ян Сарра Алан Розалія Мія Єфрем Ян Левій Лео Лука Стефанія Яна Яна Тім Вероніка Даяна Роман Анна Денис Магдалина Орися,н а а м й н а н я я м н й о а я а а м а а н а с а я,26,22~30,Output: н а а м й н а н я я м н й о а я а м а а а н а с а я,408,378,30
Естер Яна Левій Тім Ярема Анелія Веремій Лєтті Рахіль Ельдар Олівія Мартін Гордій Богдан Рувим Рахіль Діана Олександр Ельдар Таїсія Аскольд Роман,р а й м а я й і ь р я н й н м ь а р р я д н,22,22~30,Output: р а й м а я й і л р я н й н м л а р дар я д р а н,408,378,30
Тіна Ілай Естер Яків Павло Георгій Леонард Агата Марк Діана Емілія Есмі Амір Сарра Яків Єремія Ангеліна Ярослав Квітослава Єва Авенір Леонард Георгій Мартін Левій Дмитро,а й р в о й д а к а я і р а в я а в а а р д й н й о,26,22~30,Output: а й р в о й д а к а я р в я а а в а а р д й н д о,427,397,30
Денис Магдалина Амір Магдалина Леві Еліна Ельдар Анелія Аліна Захар Рамазан Магдалина Еліна Вероніка Аріна Аріна Рувим Рахіль Нестор Рамазан Лукас Макар Леонард Анна Левій Арсен Мартін Лєтті Вероніка,с а р а і а р я а р н а а а а а м ь р н с р д а й н н і а,29,22~30,Output: с а р а й а р я а р н а а а а а м л р н с р д а й н н і а,438,405,33
Аріна Олівія Магдалина Міран Квітослава Олександра Есмі Вікторія Захар Мартін Назар Назар Денис Наомі Аделіна Марк Павло Софія Заріна Аліна Данило Алан Матвій,а я а н а а і я р н р р с і а к о я а а о н й,23,22~30,Output: а я а н а а і я р н р р с і а к о я а а о н в й,401,374,27
Веремій Андрій Владислав Тімур Ярема Ярослав Ярема Анастасія Аскольд Алан Єремія Яна Агата Тіна Северин Магдалина Ілай Тімур Таїсія Тімур Естер Агата Єремія Леонард Анісія Еліна,й й в р а в а я д н я а а а н а й р я р р а я д я а,26,22~30,Output: й й в р а в а я д н я а а а а н а й р я р а я д я а а,423,391,32
Назар Ельдар Магдалина Анісія Дарина Тім Тадей Тім Ельдар Мія Вероніка Данило Павло Сарра Мілана Агата Ангеліна Тім Анастасія Діана Емілія Уляна Таїсія Георгій Еней Авенір,р р а я а м й м р я а о о а а а а м я а я а я й й р,26,22~30,Output: р р а я а м й м р я а о о а а а а м я а я я а я й й р,419,387,32
Еліна Діана Веремій Давид Єфрем Есмі Захар Агата Алім Єлизавета Єремія Рахіль Аліна Марк Наомі Софія Ангеліна Тальха Наомі Анісія Тім Емма Еліс Роман Єва Левій Арсен Анастасія,а а й д м і р а м а я ь а к і я а а і я м а с н а й н я,28,22~30,Output: а а й д м і р а м а я я л а к і я а і я м а с а н а й н я,431,398,33
Вікторія Ярина Таїсія Назар Соломія Дмитро Лея Олександр Олександра Заріна Есфір Вероніка Алан Дарина Захар Матвій Єлизавета Дмитро Олівія Ілай Анастасія Розалія Ярема Захар Гордій,я а я р я о я р а а р а н а р й а о я й я я а р й,25,22~30,Output: я а я р я о я р а а р а н а р й а о я й я я а а а й й,431,398,33
Гордій Веремій Нестор Роман Алім Арсен Лука Тальха Асаф Еліс Сінан Леонард Рамазан Северин Владислав Олександра Єремія Лукас Есфір Максим Вікторія Андрій,й й р н м н а а ф с н д н н в а я с р м я й,22,22~30,Output: й й р н м н а а ф с н д н н в а я с р м я а й,403,375,28
Роман Ілай Барбара Олександра Роман Агата Георгій Соломія Діана Уляна Яків Георгій Левій Роман Сінан Олександра Анелія Северин Еріка Лея Владислав Квітослава Лукас,н й а а н а й я а а в й й н н а я н а я в а с,23,22~30,Output: н й а а н а й я а а в й й н а я н а я в а с,409,381,28
Лука Самуїл Єфрем Леонард Тадей Емілія Владислав Рамазан Левій Богдан Яна Естер Асаф Леві Самуїл Діана Дмитро Мілана Леонард Мілана Агата Мілана Уляна Асаф Даяна Ілай,а л м д й я в н й н а р ф і л а о а д а а а а ф а й,26,22~30,Output: а л м д й я в н й н а р ф й л а о а д а а а а а а а й,425,392,33
Авенір Авенір Макар Владислав Аделіна Леонард Гордій Тиміш Павло Еріка Мартін Авенір Гордій Лєтті Соломія Назар Левій Сінан Анна Захар Вероніка Анелія Еней Даяна Таїсія Андрій Уляна,р р р в а д й ш о а н р й і я р й н а р а я й а я й а,27,22~30,Output: р р р в а д й ш о а н р й і я р й н а р а я й я а а я,431,398,33
Тальха Даяна Єфрем Ярослав Таїсія Тиміш Христина Артем Нестор Даяна Дарина Павло Амір Анастасія Сінан Ян Денис Барбара Нестор Денис Роман Яна Барбара Христина Емма Авенір Алім Меланія,а а м в я ш а м р а а о р я н н с а р с н а а а а р м я,28,22~30,Output: а а м в я ш а м р а а о р я н н с а р с а а а а р м я,419,390,29
Емма Давид Дмитро Алан Георгій Тім Северин Суламіта Вероніка Еліна Аліна Олександра Діана Веремій Леонард Вероніка Давид Олександр Артем Тадей Артем Нестор Макар Еріка Розалія,а д о н й м н а а а а а а й д а д р м й м р р а я,25,22~30,Output: а д о н й м н а а а а а а й д а а д р м й м р а а я,415,384,31
Захар Лея Ангеліна Роман Максим Максим Мілана Матвій Олівія Яна Заріна Ярина Георгій Рувим Мія Вероніка Лєтті Ярема Христина Барбара Суламіта Павло Лео,р я а н м м а й я а а а й м я а і а а а а о о,23,22~30,Output: р я а н м м а й я а а а й м я а і а а а а о о,408,381,27
Олександр Мартін Гордій Лєтті Злата Еліс Єремія Гордій Амір Стефанія Аліна Тім Єремія Діана Розалія Тальха Мілана Денис Владислав Арсен Дарина Вікторія Сарра Аріна,р н й і а с я й р я а м я а я а а с в н а я а а,24,22~30,Output: р н й і а с я й р я а м я а я а а с в н н а я а а,413,384,29
Есмі Квітослава Аскольд Мія Тиміш Уляна Орися Ярослав Роман Магдалина Емма Ангеліна Павло Аріна Еней Ярина Злата Денис Яків Тимофій Олександр Марк Рувим Ілай,і а д я ш а я в н а а а о а й а а с в й р к м й,24,22~30,Output: і а д я ш а я в н а а а о а й а а с в й р д м й,405,376,29
Тімур Даяна Ярина Орися Таїсія Самуїл Лука Яна Даяна Сарра Розалія Авенір Амір Богдан Леві Дарина Христина Алім Рувим Еліна Георгій Уляна Сарра,р а а я я л а а а а я р р н і а а м м а й а а,23,22~30,Output: р а а я я л а а а а я р р н і а а а м м а й а а,401,374,27
Давид Рувим Рахіль Яна Лука Амір Тімур Ярема Сінан Меланія Данило Емма Діана Христина Северин Квітослава Емілія Агата Тімур Захар Захар Тимофій Дмитро Вероніка Меланія Розалія Даниїл,д м ь а а р р а н я о а а а н а я а р р р й о а я я л,27,22~30,Output: д м л а а р р а н я л а а а а а я а а р р й о а я я л,427,397,30
Еліс Розалія Даяна Мартін Лукас Єремія Самуїл Олександра Злата Гордій Єремія Владислав Сінан Тиміш Рувим Лея Аделіна Агата Владислав Розалія Ярина Ярема Аліна,с я а н с я л а а й я в н ш м я а а в я а а а,23,22~30,Output: с я а н с я л а а й я в н ш м я а а а в я а а а а,405,377,28
Мілана Суламіта Ангеліна Меланія Тім Емілія Яна Розалія Самуїл Северин Назар Міран Амір Богдан Соломія Анісія Стефанія Аліна Тальха Веремій Дарина Анелія,а а а я м я а я л н р н р н я я я а а й а я,22,22~30,Output: а а а я м я а я л н р р н я я я я а а й а я,405,380,25
Наомі Северин Георгій Левій Лея Ангеліна Єлизавета Наомі Мартін Левій Тиміш Яків Міран Леві Дарина Гордій Матвій Ярина Марк Лео Барбара Ярема Тіна Квітослава Лукас Емма Дмитро,і н й й я а а і н й ш в н і а й й а к о а а а а с а о,27,22~30,Output: і н й й я а а і н й ш в н й а й й а к о а а а а а с а о,436,400,36
Арсен Орися Вікторія Заріна Тімур Рахіль Дмитро Олександр Авенір Лука Ярина Квітослава Барбара Суламіта Міран Міран Ян Денис Орися Міран Олівія Анна Таїсія,н я я а р ь о р р а а а а а н н н с я н я а я,23,22~30,Output: н я я а р л о р р а а а а а н н н с я н я а я,407,382,25
Ян Леонард Данило Марк Анісія Еліс Роман Левій Мія Сінан Арсен Злата Аскольд Авенір Лука Злата Максим Нестор Тіна Суламіта Есмі Еней,н д о к я с н й я н н а д р а а м р а а і й,22,22~30,Output: н д о к я с н й я н н а д р а а а м р а а і й,391,364,27
Єфрем Роман Соломія Єремія Олександра Анна Ярина Стефанія Софія Дмитро Квітослава Анелія Міран Мія Ярема Ілай Естер Наомі Єлизавета Стефанія Анна Авенір Макар Тадей,м н я я а а а я я о а я н я а й р і а я а р р й,24,22~30,Output: м н я я а а а я я о а я н я а й р і а я а а р р й,413,384,29
Аделіна Аріна Павло Георгій Ян Макар Даяна Артем Анісія Асаф Діана Злата Тальха Анна Уляна Софія Барбара Амір Емма Емма Тальха Олександр,а а о й н р а м я ф а а а а а я а р а а а р,22,22~30,Output: а а о й н р а м я ф а а а а а а я а р а а а р,391,365,26
Емілія Аріна Тальха Матвій Еріка Агата Сарра Тимофій Анісія Дмитро Агата Захар Макар Арсен Тиміш Еліна Северин Заріна Аскольд Георгій Левій Есмі Лео Олександр Барбара,я а а й а а а й я о а р р н ш а н а д й й і о р а,25,22~30,Output: я а а й а а а й я о а р р н ш а н а д й й і о р а,419,388,31
Олівія Роман Нестор Єфрем Вікторія Ярослав Мартін Северин Таїсія Марк Еріка Есмі Лея Лєтті Еліна Георгій Таїсія Дмитро Левій Дарина Денис Даниїл Ілай,я н р м я в н н я к а і я і а й я о й а с л й,23,22~30,Output: я н р м я в н я к а і я і я а й я о й а с л й,412,384,28
Тадей Магдалина Рувим Дмитро Гордій Лукас Ярема Еліна Северин Сінан Артем Ярослав Тальха Діана Тімур Лукас Лукас Софія Тімур Яків Аделіна Емма Міран Ельдар Рамазан Ярина,й а м о й с а а н н м в а а р с с я р в а а н р н а,26,22~30,Output: й а м о й с а а н м в а а а р с с я р в а а а р а а а,419,388,31
Анісія Олівія Богдан Олександра Соломія Дмитро Амір Стефанія Суламіта Рамазан Сінан Павло Леві Есфір Барбара Денис Міран Тім Ангеліна Алан Тім Яків Ярослав Соломія Злата,я я н а я о р я а н н о і р а с н м а н м в в я а,25,22~30,Output: я я н а я о я а н о о і в р а с с н м а н м в в я а,417,389,28
Амір Рахіль Емма Єва Квітослава Магдалина Гордій Тадей Назар Ярослав Міран Даяна Анісія Аскольд Матвій Еріка Рувим Розалія Мія Тадей Авенір Ян Тальха Давид Софія,р ь а а а а й й р в н а я д й а м я я й р н а д я,25,22~30,Output: р л а а а а й й р в а а я д й а м я я й р н а д я,412,381,31
Естер Ілай Алан Ян Олівія Христина Амір Тадей Дарина Діана Заріна Георгій Северин Аскольд Давид Мія Давид Аліна Лукас Естер Магдалина Соломія Самуїл Олівія Єлизавета Лео Рамазан Аскольд,р й н н я а р й а а а й н д д я д а с р а я л я а о н д,28,22~30,Output: р й н н а а р й а а а й н д д я д а с р а я я л я а о а д,431,397,34
Данило Міран Давид Орися Олівія Веремій Вікторія Еней Максим Алан Есмі Андрій Ян Мартін Владислав Анна Вероніка Андрій Артем Тиміш Данило Леонард Денис Діана Уляна Яна Олівія Тімур,о н д я я й я й м н і й н н в а а й м ш о д с а а а я р,28,22~30,Output: о н д я я й я й м н і й н ін в а а й й ш о д с а а а я я р,428,391,37
Ярослав Ілай Гордій Сарра Лея Соломія Назар Сінан Ян Макар Таїсія Арсен Анелія Мілана Северин Лукас Анісія Ангеліна Еріка Андрій Данило Тимофій Левій Діана Лея Ельдар Тимофій,в й й а я я р н н р я н я а н с я а а й о й й а я р й,27,22~30,Output: в й й а я я р н н р я н а а н с я а а й л й й а я р й,435,400,35
Северин Владислав Лєтті Сарра Лєтті Самуїл Максим Асаф Емма Еней Аріна Єремія Олександра Есмі Квітослава Христина Тиміш Суламіта Павло Тальха Рувим Єва Заріна Амір,н в і а і л м ф а й а я а і а а ш а о а м а а р,24,22~30,Output: н в і а і л м ф а й а я а і а а ш а о а м а а р,412,385,27
Роман Еліс Діана Леонард Макар Самуїл Емма Денис Веремій Емма Роман Аліна Рувим Тіна Георгій Магдалина Сінан Артем Владислав Леві Заріна Олександра Анісія Сарра Самуїл Еріка Роман Есмі Роман,н с а д р л а с й а н а м а й а н м в і а а я а л а н і н,29,22~30,Output: н с а д р л а с й а н а м а й ина н м в а іна а я а л а м і а,433,398,35
Міран Магдалина Аскольд Міран Анелія Олександр Левій Агата Дарина Асаф Вероніка Павло Ярема Орися Лукас Мілана Даниїл Суламіта Рамазан Мартін Мілана Яна Данило Ян Вероніка Мілана Тадей,н а д н я р й а а ф а о а я с а л а н н а а о н а а й,27,22~30,Output: н а д н я р й а а ф а о а я с а л а н а н а а о н а й,422,391,31
Меланія Артем Еліна Матвій Міран Уляна Гордій Вероніка Мілана Северин Самуїл Гордій Дарина Еліна Тальха Захар Павло Тіна Емілія Денис Уляна Софія Яна Ян Олександр,я м а й н а й а а н л й а а а р о а я с а я а н р,25,22~30,Output: я м а й н а й а а н л й а а а р о а я с а я я н р,412,382,30
Сінан Тальха Стефанія Лея Алан Магдалина Рахіль Ярина Мартін Ельдар Ельдар Мартін Лукас Ярина Квітослава Емілія Рахіль Дарина Лея Суламіта Соломія Еліс Єремія,н а я я н а ь а н р р н с а а я ь а я а я с я,23,22~30,Output: н а я а н а л а н р р н с а а я л а я а я с я,409,384,25
Єремія Амір Олександр Еней Рахіль Тимофій Есмі Емма Леонард Злата Стефанія Денис Алім Даниїл Лукас Аделіна Лукас Єлизавета Тіна Злата Нестор Олександра,я р р й ь й і а д а я с м л с а с а а а р а,22,22~30,Output: я р р й л й і а д а я с м л с а с а а а та ра,404,376,28
Уляна Мартін Ангеліна Захар Олександр Левій Ярема Олександр Суламіта Ярослав Розалія Мія Сарра Стефанія Лея Яна Макар Левій Леонард Марк Нестор Данило Розалія Авенір Орися,а н а р р й а р а в я я а я я а р й д к р о я р я,25,22~30,Output: а н а р р й а р а в я я а я а а р й д к р о я р я,415,386,29
Єремія Орися Георгій Еней Ілай Арсен Магдалина Лєтті Давид Тім Магдалина Олександра Тадей Тимофій Єва Леві Рувим Єремія Емма Сарра Квітослава Христина,я я й й й н а і д м а а й й а і м я а а а а,22,22~30,Output: я я й й й н а і д м а а й й а і м я а а а а,405,376,29
Таїсія Рахіль Максим Артем Северин Захар Олівія Самуїл Андрій Данило Тімур Анісія Максим Таїсія Мартін Левій Аліна Мія Тімур Стефанія Мілана Марк Асаф Тадей,я ь м м н р я л й о р я м я н й а я р я а к ф й,24,22~30,Output: я л м м н р я л й о р я м я н й а я р я а к ф й,416,387,29
Левій Суламіта Лєтті Леві Денис Георгій Таїсія Арсен Самуїл Рамазан Барбара Ангеліна Денис Ярослав,й а і і с й я н л н а а с в,14,8~15,Output: й а і і с й я н л н а а с в,367,349,18
Алім Тімур Єфрем Рахіль Марк Сарра Барбара Олександр Андрій Сінан Єлизавета Макар Соломія,м р м ь к а а р й н а р я,13,8~15,Output: м р м л к а а р й н а р я,352,336,16
Єва Гордій Єва Анісія Аделіна Макар Дмитро Єфрем Мартін Макар Ярина Уляна Тім,а й а я а р о м н р а а м,13,8~15,Output: а й а я а р о м н р а а м,345,329,16
Дарина Мія Есмі Анна Сарра Лео Асаф Анастасія Сарра Барбара Вероніка Анісія,а я і а а о ф я а а а я,12,8~15,Output: а я і а а о ф я а а а я,342,328,14
Леонард Естер Квітослава Тиміш Асаф Тімур Сарра Роман Єремія Левій Розалія,д р а ш ф р а н я й я,11,8~15,Output: д р а ш ф р а н я й я,342,328,14
Макар Веремій Гордій Мілана Богдан Таїсія Яна Квітослава Емма Рувим Есмі Сінан Захар Тальха,р й й а н я а а а м і н р а,14,8~15,Output: р й й а н я а а а м і н р а,359,341,18
Уляна Міран Анна Ярослав Олександр Еліс Орися Денис Соломія Гордій,а н а в р с я с я й,10,8~15,Output: а н а в р с я с я й,331,318,13
Ілай Алан Аріна Тіна Есфір Роман Тальха Анелія Ярина Рувим Стефанія Леонард,й н а а р н а я а м я д,12,8~15,Output: й н а а р н а я а м я д,345,330,15
Лео Анісія Барбара Артем Веремій Єлизавета Тальха Лукас Рувим Еліс Левій Даниїл Таїсія Андрій,о я а м й а а с м с й л я й,14,8~15,Output: о я а м й а а с м с й л я й,368,349,19
Павло Емілія Назар Розалія Алан Емма Рувим Лео Лєтті Розалія Роман,о я р я н а м о і я н,11,8~15,Output: о я р я н а м о і я н,338,325,13
Заріна Марк Ярина Авенір Аріна Дарина Тальха Злата,а к а р а а а а,8,8~15,Output: а к а р а а а а,319,309,10
Сінан Лука Тимофій Даяна Орися Тиміш Сінан Злата Анастасія Тім Лея Вікторія Тім Магдалина,н а й а я ш н а я м я я м а,14,8~15,Output: н а й а я ш н а я м я я м а,355,338,17
Ярина Єлизавета Алан Тімур Нестор Рахіль Владислав Захар Арсен,а а н р р ь в р н,9,8~15,Output: а а н р р л в р н,328,317,11
Магдалина Андрій Міран Анісія Дмитро Наомі Єва Магдалина Дмитро Сінан Рувим Владислав Еріка Левій,а й н я о і а а о н м в а й,14,8~15,Output: а й н я о і а о н м в,355,341,14
Аріна Розалія Квітослава Софія Емілія Аріна Діана Денис Дарина Амір,а я а я я а а с а р,10,8~15,Output: а я а я я а а с а р,336,324,12
Есмі Дмитро Барбара Артем Марк Северин Єва Аскольд Анелія Діана Ілай Данило Яна Авенір,і о а м к н а д я а й о а р,14,8~15,Output: і о а м к н а д я а й о а р,352,335,17
Магдалина Вікторія Христина Есмі Єфрем Андрій Анелія Ярина Аскольд Лео Дарина Тадей,а я а і м й я а д о а й,12,8~15,Output: а я а і м й я а д о о а й,348,331,17
Авенір Леві Даниїл Олександра Мія Артем Амір Ярослав Тімур,р і л а я м р в р,9,8~15,Output: р і л а я м р р,327,317,10
Сінан Богдан Лєтті Анелія Андрій Георгій Анастасія Веремій Асаф Ярема Владислав,н н і я й й я й ф а в,11,8~15,Output: н н і я й й я й ф а в,349,333,16
Христина Алан Єфрем Алім Магдалина Олександра Таїсія Андрій Злата Давид Леонард Ілай,а н м м а а я й а д д й,12,8~15,Output: а н м а а я й а д д й,348,333,15
Заріна Самуїл Анелія Павло Дмитро Заріна Алан Мія Авенір Яків Сарра,а л я о о а н я р в а,11,8~15,Output: а л я о о а н я р в а,338,325,13
Алан Сарра Богдан Уляна Аделіна Вероніка Рамазан Аріна Еліс Рувим,н а н а а а н а с м,10,8~15,Output: н а н а а а н а с м,329,317,12
Арсен Естер Тадей Єремія Левій Алан Олександр Захар Алім Лукас,н р й я й н р р м с,10,8~15,Output: н р й я й н р р м с,334,320,14
Еліс Емілія Матвій Олександр Еней Магдалина Єва Наомі Тальха Ян,с я й р й а а і а н,10,8~15,Output: с я й р й а а і а а н,336,321,15
Ярема Єремія Ярослав Анісія Христина Емілія Заріна Меланія Олександр Арсен Наомі Данило Стефанія Андрій,а я в я а я а я р н і о я й,14,8~15,Output: а я в я а я а я р н і о я й,362,345,17
Есфір Лєтті Еней Анастасія Асаф Алім Даниїл Тимофій Ангеліна Ангеліна Алан Магдалина Еліна Меланія,р і й я ф м л й а а н а а я,14,8~15,Output: р і й я ф м л й а а н а а я,366,348,18
Аскольд Матвій Ярема Анна Назар Аліна Сінан Рамазан Алім,д й а а р а н н м,9,8~15,Output: д й а а р а н н м,326,314,12
Алім Софія Тімур Владислав Тім Яна Анелія Северин Квітослава Гордій Матвій Софія,м я р в м а я н а й й я,12,8~15,Output: м я р в м а я н а й й я,349,333,16
Барбара Алім Ілай Аделіна Арсен Олівія Тадей Марк Роман Артем Діана Стефанія Суламіта,а м й а н я й к н м а я а,13,8~15,Output: а м й а н я й к н м а я а,352,335,17
Ангеліна Олександра Лєтті Лука Сінан Діана Артем Суламіта Міран Сарра Суламіта Діана,а а і а н а м а н а а а,12,8~15,Output: а а і а н а м а н а а а,349,335,14
Лєтті Тімур Авенір Таїсія Соломія Дмитро Анна Ярема Даниїл Мілана Гордій Рахіль Заріна Андрій,і р р я я о а а л а й ь а й,14,8~15,Output: і р р я я о а а л а й л а й,366,348,18
Дарина Тім Арсен Лукас Самуїл Леонард Левій Андрій Сарра Аскольд Вероніка Лукас Рамазан Міран,а м н с л д й й а д а с н н,14,8~15,Output: а м н с л д й й а д а с н н,358,340,18
Павло Самуїл Агата Роман Яна Авенір Христина Матвій Роман Орися,о л а н а р а й н я,10,8~15,Output: о л а н а р а й н я,332,319,13
Софія Міран Даяна Есфір Єлизавета Амір Олександра Ян,я н а р а р а н,8,8~15,Output: я н а р а р а н,324,314,10
Рахіль Єва Ангеліна Еней Тиміш Еріка Северин Лука Давид Алім,ь а а й ш а н а д м,10,8~15,Output: л а а й ш а н а д м,332,319,13
Христина Олександра Олександра Авенір Асаф Софія Даяна Денис Давид Софія,а а а р ф я а с д я,10,8~15,Output: а а а р ф я а с д я,334,322,12
Дарина Наомі Владислав Лукас Давид Стефанія Нестор Гордій,а і в с д я р й,8,8~15,Output: а і в с д я р й,323,312,11
Орися Еріка Тальха Гордій Стефанія Аделіна Ярослав Тиміш Амір,я а а й я а в ш р,9,8~15,Output: я а а й я а в ш р,330,318,12
Северин Мілана Лєтті Барбара Анелія Богдан Соломія Суламіта Лука,н а і а я н я а а,9,8~15,Output: н а і а я н я а а,335,324,11
Анелія Мілана Мартін Еліна Аріна Агата Уляна Назар Діана Дмитро Аліна,я а н а а а а р а о а,11,8~15,Output: я а н а а а а р а о а,336,323,13
Леві Даниїл Тальха Тимофій Ян Тиміш Ангеліна Назар Анісія Лея Лукас Алім Тимофій Ярина,і л а й н ш а р я я с м й а,14,8~15,Output: і л а й н ш а р я я с м й а,361,343,18
Лея Леві Максим Макар Лєтті Гордій Міран Дмитро Олександра,я і м р і й н о а,9,8~15,Output: я і м р і й а о а,330,318,12
Ярема Міран Асаф Ангеліна Тимофій Рувим Макар Макар Аріна,а н ф а й м р р а,9,8~15,Output: а н ф а й м р а,327,316,11
Вікторія Еліна Павло Лукас Мартін Рувим Асаф Таїсія Діана,я а о с н м ф я а,9,8~15,Output: я а о с н м ф я а,331,320,11
Данило Уляна Таїсія Уляна Квітослава Магдалина Леонард Даниїл Мія Соломія Максим Нестор Тимофій,о а я а а а д л я я м р й,13,8~15,Output: о а я а а а д л я я м р й,354,338,16
Тиміш Єремія Анісія Матвій Міран Дарина Єлизавета Яна Орися,ш я я й н а а а я,9,8~15,Output: ш я я й н а а а я,331,319,12
Яна Суламіта Лука Анастасія Алім Еліс Сарра Емма,а а а я м с а а,8,8~15,Output: а а а я м с а а,322,312,10
Еней Лєтті Ярина Левій Владислав Гордій Рахіль Лукас Левій Ярослав,й і а й в й ь с й в,10,8~15,Output: й і а й в й л с й в,342,326,16
Сінан Рамазан Ельдар Тімур Павло Арсен Аліна Тимофій Розалія Даяна Олександра Есфір Ян Заріна,н н р р о н а й я а а р н а,14,8~15,Output: н н р р о н а й я а а р н а,354,337,17
Захар Софія Емілія Левій Діана Емма Розалія Аделіна Барбара Меланія Лука Олівія Максим,р я я й а а я а а я а я м,13,8~15,Output: р я я й а а я а а я а я м,354,338,16
Анісія Міран Лео Северин Олександра Емма Емма Аделіна Еліс,я н о н а а а а с,9,8~15,Output: я н о н а а а а с,326,315,11
Мартін Аліна Еліна Суламіта Данило Розалія Тиміш Соломія Гордій Меланія Олівія,н а а а о я ш я й я я,11,8~15,Output: н а а а о я ш я й я я,344,330,14
Еліс Діана Тім Владислав Есмі Наомі Аліна Тіна Заріна Соломія Лука Меланія,с а м в і і а а а я а я,12,8~15,Output: с а м в і і а а а я а я,341,327,14
Тимофій Злата Есмі Олександр Тімур Лука Тиміш Аріна,й а і р р а ш а,8,8~15,Output: й а і р р а ш а,324,313,11
Єремія Христина Таїсія Богдан Уляна Георгій Давид Олександра Дарина Єфрем Христина,я а я н а й д а а м а,11,8~15,Output: я а я н а й д а а а,342,329,13
Тімур Дарина Матвій Ярина Анісія Павло Магдалина Магдалина,р а й а я о а а,8,8~15,Output: р а й а я о а а,325,314,11
Алан Есфір Есфір Еліна Розалія Давид Тіна Тиміш,н р р а я д а ш,8,8~15,Output: н р р а я д а ш,321,311,10
Есфір Еліна Дарина Тальха Естер Рамазан Єва Еріка Леві Артем Еріка,р а а а р н а а і м а,11,8~15,Output: р а а а р н а а і м а,334,321,13
Еліс Суламіта Тадей Соломія Алім Єремія Яків Рахіль Еріка,с а й я м я в ь а,9,8~15,Output: с а й я м я в л а,332,320,12
Павло Аскольд Орися Лукас Нестор Ельдар Макар Лея Тальха Вероніка Магдалина Левій,о д я с р р р я а а а й,12,8~15,Output: о д я с р р р я а а а а й,344,328,16
Нестор Марк Єремія Аскольд Аскольд Мія Тиміш Міран Емма Тімур Міран,р к я д д я ш н а р н,11,8~15,Output: р к я д д я ш н а р н,331,318,13
Захар Олівія Ярема Гордій Северин Ілай Есмі Ельдар Лука Рахіль Даяна Ілай Агата,р я а й н й і р а ь а й а,13,8~15,Output: р я а й н й і р а л а й а,351,333,18
Матвій Лея Даниїл Самуїл Авенір Артем Заріна Сінан Даниїл,й я л л р м а н л,9,8~15,Output: й я л л р м а н л,333,321,12
Тімур Анісія Емілія Давид Еліс Лео Тиміш Єлизавета,р я я д с о ш а,8,8~15,Output: р я я д с о ш а,327,317,10
Олівія Агата Стефанія Олександра Авенір Давид Даяна Тиміш Тальха Барбара Яків Сарра Алім,я а я а р д а ш а а в а м,13,8~15,Output: я а я а р д а ш а а в а м,350,335,15
Олександра Аскольд Тімур Георгій Христина Алім Есмі Діана Емілія Алім Левій Ярослав Стефанія Суламіта,а д р й а м і а я м й в я а,14,8~15,Output: а д р й а м і я м й в а я а,364,346,18
Орися Роман Ілай Діана Діана Рахіль Данило Олександра,я н й а а ь о а,8,8~15,Output: я н й а а л о а,322,311,11
Еліс Тадей Северин Суламіта Тимофій Арсен Тимофій Есфір,с й н а й н й р,8,8~15,Output: с й н а й н й р,330,317,13
Еліна Алім Арсен Яна Ярема Леві Соломія Лука Левій Павло Анелія,а м н а а і я а й о я,11,8~15,Output: а м н а а і я а й о я,338,324,14
Орися Еріка Веремій Христина Агата Владислав Олександр Леонард Алім Дарина Ілай,я а й а а в р д м а й,11,8~15,Output: я а й а а в р д м а й,341,326,15
Левій Левій Еліс Самуїл Ярема Рахіль Еліна Богдан Северин Захар,й й с л а ь а н н р,10,8~15,Output: й й с л а л а н н р,338,324,14
Рахіль Аделіна Квітослава Христина Дарина Вероніка Олександр Ілай,ь а а а а а р й,8,8~15,Output: л а а а а а р й,328,317,11
Авенір Анастасія Тіна Мія Георгій Вікторія Асаф Еліс Даяна Северин Анелія Максим Аріна Георгій,р я а я й я ф с а н я м а й,14,8~15,Output: р я а я й я ф с а н я м а й,359,341,18
Давид Захар Еліна Рахіль Агата Тім Лео Ельдар Еней Андрій,д р а ь а м о р й й,10,8~15,Output: д р а л а м о р й й,331,317,14
Злата Ярема Марк Ельдар Мія Тімур Олександр Леві Анісія Тіна Богдан Стефанія Вікторія,а а к р я р р і я а н я я,13,8~15,Output: а а к р я р р і я а н я я,349,334,15
